|------------B?-o----B--B-B--oB-----?------B-B--------E----B------BB-----------------------B-Bo-----o--------?-----------------------------------?--B----------B------------B-----------BBB-o------o---X
|BB--------------B-----------------------------B--B---BB--------------E---B--B---------B---o?------B--------B--------E--------------B---?B----------B-o-----B---------BB--oB---------B---B----M------B-T
X-------B------------------------B-B--------B-B----------------?B-----Bo---------------?---------------------B---?---B---B----B---B-----------B------B---------------------B--o----------------M--M-B--X
E--B-----?---B--------?----------B-B-------B----M-----B---B-----------B-------B----o--o--------------B---o---B---o-B---B--B--?----BB------?--?----B------o--B----------B-B----------------------------BX
|---?----------B--------B---B------B--?--------------M--------------B-------------BB-----?---------------------M----------?-B--------B-?-------------B-------------------------------------------------X
|------------B---o------------------B--MB------E------B-B------B----------B--------B-------B----------?------B--------B-B----B-B-BBB----------B---BB-------------B----------Bo-----------------?-------|
X-----?-B----M-------------------B----E-------BB--M----------B------------o--B--------?-B--------------B---------B---------B------o--------------------------?-?-?-----BB----------------------B-----?-X
XB-o------------B---------?------o----B-----------B----------B----------B---B----E-B----B-BE-B-B-----o-----E-B-B-------------------?----?-------------------------------?---BM--B---------?------BB----v
B-------o-----------B---BB---E---B-B--------B---------o---B-------B----------?---B---B-----BE----B----Bo---B--B--?-??-----------------------------B-B-BB----------B-----------------------E----------B-X
X-------B--------------------B----B--------------B------------?----B------B-B-------E-------B---TB------B---B---------T-----------------B-----------E-E---?-----o------------------------BB?----------?X
|E-----?B---T--o------------B--------E-------------------E---?----------------------B--M---B-B--|---?B---B--B--------B|--------B--o--------T------ETXoB?-----B-BoB-------------?------------------B----X
-B----BB----|BB----------T------?----B----o-----B--------B----------------------B---------T-----|----B--T-----?B-B----|------B-MB----B-B---|----B-B|X-----T-------------------B-M--------------o-------T
|-E-B----TB-|--EB--------|--T--B-?-?-----B-TT----oBTT-------T-T-B----B-B----X----T?-T-----|-----|---T---|-?-T---------X--B-----------------|-----B-|XT-BB-|-T-----B--------B--E-----------X---------T---
XXB---T-B|E-|T-BB-B--X---X--|-B-T-----B----||----o-||-------|-|-------------X--T-|TT|----T|-----|-X-|---|--T|---------X----TTTTT-BTTTX--T--|-TB--T-XX|----|-|----TB-B-----EB--X-T------TT-XT--o-B---|--|
mXB---|B-|X-||-X-B-BBX---X--|-E-|------B--E|X-----EX|--E-B--X-|-X-----------X--|B|||X-E-E|X-BX-EXEX-X-E-|oE||BB--E----X----|||||-X|||X--|--XX|E--|BXX|-B--XE|-XE-|E--B-X-XXB--X-|-E--E-||-X|--B---EEX--B
XXXXXXXXXXXXXXXXXXXXXXXXXXXXXXXXXXXXXXXXXXXXXXXXXXXXXXXXXXXXXXXXXXXXXXXXXXXXXXXXXXXXXXXXXXXXXXXXXXXXXXXXXXXXXXXXXXXXXXXXXXXXXXXXXXXXXXXXXXXXXXXXXXXXXXXXXXXXXXXXXXXXXXXXXXXXXXXXXXXXXXXXXXXXXXXXXXXXXXXX
