E------o-B----o---B--B----oB--------B---B---B----B--o---o-o--------B---B------------------------o------------------B---------------o-----o-----------o---B-----B------o--Bo-------B--------B--B--oB----B
-----------------------------B-B--B-BB-------B------------------------------------o-------------B------------------------o--B----------------------------------------o--------BB---------B-------------X
E---------------B--------------B----B--------------o--o--o-----------B----ooo--B-B-------------------------o-B-----------------o---B--B-----------B-------------B------------B--o-----B----o---------BBM
X------------------B--------B------------B----------oo-B-B-------o--Bo-----B---o-----------------o--o------------B-----------B-----------B-o-------------B--o----------o-------------------B-------oB--B
?-------------o------o--------------------------oB----B----------B---o-o------B----Bo----------------B-------B------o----B-B---------B-------BB---------------------B---B-----B---------o--------------T
E-----------------o-----B-------------------------------------------o----------------------------B----o-----------o---------B---------o--B----------o-----B--BB----------o--o-----o-----B--------------X
M---------B---------BB----o----------------o---------------------B---------o----o------------B----------------o---------B--o---B-------------B-------o-------------o---B---B----------o--------BB------?
E----------?M----B-------B-B--------o------------Bo-----------------------------------------------B------o----------B--B-B-----------o----------o------------------------BBB------o--B-----?--------B--v
o-------?-Mo-------B-B-----------o--------------B-------------------------Bo-------B-----B--o-oo-------o-Bo-----o-o-----------------o----B-------o------B------------------o--------------o-B------o---|
|--o---------------B---------------o-------------------------------o---B-------------oB---B-B----?--------B-o---B---B-------------B--M-B-B--------o-----B---o--B---------B--------B---?---------M------X
E------o------B------------o------B---o--o--o------TB----T--B---------------B---o-------------T-----B--o----------o-o-----------BB--o-------------------------o--oB---B---B--------B-------------------|
B-------o--o?-B-M----?----M--B---o---M--------?-M--|---B-|B-o------------?B----M---T----------|-----M--oB---?--B-------o-?-----M-------M----------M--B---------BB---M-------T?--------M--?--T--o-------X
--------T-M---------?-----B---?---------B----T--o--|-----|--B--o?---oTMoo--?-----o-|-------o?-|---T------o---T---------------------T-M-----B-o---o-----T---M-----o--------o-|--M------------|---Bo-----M
?T-----o|--------?-o---------o-----M---------|--T--|----?|?------T---|-------------|o-o-B-o---|-?-|?M--Bo----|----B--B--o-T-----B--|--T----o--------M-?|-B?---B-o--o-M----B-|--------?-T----|--B-?-B--oB
m|o--X--|--X-B---------E------o--------B---X-|-o|-B|-E-o-|------B|-X-X-o--X-E-X----|o---X-----|-o-|o----o----|-------E--B-|--E-----|-E|o---B-XX---B--Eo|--BB------B----X----|---E--B---|----|---X----B-T
XXXXXXXXXXXXXXXXXXXXXXXXXXXXXXXXXXXXXXXXXXXXXXXXXXXXXXXXXXXXXXXXXXXXXXXXXXXXXXXXXXXXXXXXXXXXXXXXXXXXXXXXXXXXXXXXXXXXXXXXXXXXXXXXXXXXXXXXXXXXXXXXXXXXXXXXXXXXXXXXXXXXXXXXXXXXXXXXXXXXXXXXXXXXXXXXXXXXXXXX
