|---?-----B---B--B------B-----?--------------B-----B-E---E-----------------B--?----------------------------B--E-B---?----B----------?------B---M-------------------------------B-------B---------------X
T-----------------------------B-----?----------------B---B-------o-------------?---B---B----------------------B------E----------?---B--------------------B--------B-?---?-------B----B-B-?-B-----------|
B--o----B-------------B----------------------B----B-B---B---------------?--B-----B----B----o-----o--------B----------B------------------o--o-----B---------B--------B-----------o-----B----?-----------X
B----B----------B----------------??---------E-B---------B-B-o--B--------------------B-----------E---------BoE---------B--B-?B---B--------------B-----------M-------------?------------------------?----X
|---------BB---------------B----------------BE---?B-----?---B-------B----?-----?----B------B--B-B-B-----B---B----B--------?------------B----------B-----------BB---M------B--B----------------?--B----B|
X-B---B---------------?-B--------B----------BB-----------?----B?-EB-----------o-----B----------B------?------------B-------------?---B-?------B---B--o-----BB-----B-----B-?-BE------B----------------B-T
X---E---------B-----B-----------B----B-BB------------------------B------BB---o-B?--------B-----------B------------------B-------B----------E---------B?----B-----------------B---------B------B--------?
X---B--------B-----BB----o---------B----B--------B------B---o---------B-----B--B---B---------o-----------M--?--------------------E----B----B---------------------------------------------------M-------v
|?--------BB----------------?----o-------BB-------B-------T-----BB-------?---B--------------?-----------E-B----------------------B?-B--?-----B-B----?-B-----------Bo------B--B-------------------B-----|
------?----B------B--------------B--?---M-----MB---B-----B|-B-------------T--------B-------------B-----BB-------B-B------------B--------o----BB------------------------B-----B---B---B--------TB-----B-X
X-----o-------------B-B?-------------------------B------E-XB--?-----------|--------?---E-----B---------B-----------------------------?---------?-o--------BB-B----------B-B?--B---------------|--------|
X-----B------T--------BoB-T----B--------B----------T----B-X-----B-----T--M|-----B-TBB--X---------B---------o--B--------B-T----B-----T---------o----B---------B-------M------?--B-B-----B----B-|-B---M--B
X-----?------|--T-TEBB-TT-|--o----TB--B---E------?-|T-----X---B-------|B-BX---o---|----X-------------------T--------T----|---B------|--T------BBT-o-TB-E-B-----o-X---oE------B--M--o----------|--------|
B-T------BT-TX-B|-|X-T-||-|BXT----|BT-X---BB-B-----||--E--XB-----T-ET-X-T-X-----T-|--T-XX-T-T------B--T----|--------|-B-T|T---------|T-|------TX|---|T-X----B-T--X----B------T------B-----B-T-X-------TX
mX|-E-B--X|X|X--XEXXB|BXXEX-X|-X--|-|-X---X-E------|X-BXB-X---BB-|-B|-X-|-X-----|X|-X|-XXB|-|-----X---|---XX------E-|---|||BEE--X---||-XE-----|XXE-B||-XXX---o|--X------E----|B---EEX---EEo-|-X-E----B|X
XXXXXXXXXXXXXXXXXXXXXXXXXXXXXXXXXXXXXXXXXXXXXXXXXXXXXXXXXXXXXXXXXXXXXXXXXXXXXXXXXXXXXXXXXXXXXXXXXXXXXXXXXXXXXXXXXXXXXXXXXXXXXXXXXXXXXXXXXXXXXXXXXXXXXXXXXXXXXXXXXXXXXXXXXXXXXXXXXXXXXXXXXXXXXXXXXXXXXXXX
