--------------------------------------------------------------------------------------------------------------------------------------------------------------------------------------------------------
--------------------------------------------------------------------------------------------------------------------------------------------------------------------------------------------------------
----------------------------------------------------------------------------------------------------------o---------------------------------------------------------------------------------------------
--------------------------------------------------------------------------------------------------------------------------------------------------------------------------------------------------------
--------------------------------------------------------------------------------------------------------------------------------------------------------------------------------------------------------
--------------------------------------------------------------------------------------------------------------------------------------------------------------------------------------------------------
------------------------------------o-------------------------------------------------------------------------------------------------------------------------------------------------------------------
-------------------------------------B-----------------------------------------------------------------------------------------------------------------------------------------------------------------v
-------------------------------------------------------------------------------------------------------------------------------------------------------------------------------------------------------f
------------------------------???----------------------------------------------------------------------------------------------------------------------------------------------------------------------f
--------------------------------------------------------------------------------o-------------------------------------------------------------------???????--------------------------------------------f
------------------------------------------X-----------------T-----------------------------M------------------------------------------------------------------------------------------------------------f
------------------------------------------XX----------------|------------------X-----------------------------------------------------------------------------------------------------------------------f
-----------T------------------------------XXX---------------|------------------------------------------------------------------------------------------------------------------------------------------f
m---E------|------------------------------XXXX--------------|--------------XX--------------E---------E-------------------------------------------------------------------------------------------------X
XXXXXXXXXXX|XXXXXXXXXXXXXXXXXXXXXXXXXXXXXXXXXXXXXXXXXXXXXXXX|XXXXXXXXXXXXXXXXXXXXXX------XXXXXXXXXXXXXXXXXXXXXXXXXXXXXXXXXXXXXXXXXXXXXXXXXXXXXXXXXXXXXXXXXXXXXXXXXXXXXXXXXXXXXXXXXXXXXXXXXXXXXXXXXXXXXXX
