-----B--B-----------?--------o-B---------B-----BB--------------------B------B------B----------------?-----------------B-----B---oo---------B-??-BBB-----?B----------B-----o-----------------?---------BX
X----------------------?---BB--------------------B------------o----------------oB----------?-------?-------B-----------B----------?-------B?-BBE-?-B----o------------------------B-B----------o--------|
E--------B-E---B-------------B------B-M-----------------------------oB---BB------------------------B-?--B----B------------B------?-----B-------B-B-----B--?-B-------?------B-?B----E-------------B---B-|
X----------B-M--B----B----E-B--M----?---B------------------B---------?------------BB--------?--------------E-------------B------------------B--------------BB---B---B-o---B----B---B--B------B------B--|
X---?----------------B--B-BB---B?------------------B-E--------------------?------------o?--B------------o--B----------------------o--------------B--------------------------------------B----?--?------X
X------------------------B-----E--------B--B---------B--?-B-B--B------------------o?----BE------B--------------------------B------B-----o-B-----------?---B----------------B--B?------------------------
|--?----E-----------BB---------B--B-----------------B-----o---------?--------------------B-?--------?--B-------B---------------B--------------------------oB----E-----B---M--B-------------------------T
XM-B--o-B-----M-------------------M-B-?B?------?---E------------------B----------------o-B--E-------------------------------------------B----B-B----------------B------------o------------B------------v
X-------------B------E---B-----------------B-------BB-----B------------------B-----B--------B-B-------------B---?-?-----------?--E------?B-----------B----BBB-B--B----------------M----B--------EB-----|
|---E--------------BoB----------B------o---B----------B------------M-------B-------oB-o------B-B-----?---------B-------EBo-------B----------?-------E----------------E--------?---------B--Bo-B-B----E-?
Bo--B-------B-------B---B--B-----------------E-B?------B-T---B----------B--------?--------?--BB------------B--?--------B--------------B--B---B-?----B----------------B---------------B---B----B-B----B-X
-------E------------E---------B----T-?-?-----B----B------|----------------------?-T-B---B---TT-----T---T--------T-T----T-----E-----T-----B--EB----M-----------------------B------B--------o------------|
|--B---X-T-------T--B--o-------B---|---B-----------------X---T-----T--BE----T-----|-T-------||T--B-|--E|--------|-|---B|--B--B----X|--------X----B--T----------?-----TTB----E-----T---B---X--B--BT-----|
-------X-|B---TB-|B----------B----E|TB-T-T-T------E---B--X-T-|-B-E-|---XTT-T|TE-T-|T|-------|||-B-T|-TXX-TX----T|E|-ETT|----T-B-E-X|TB-T--BTX-TBBB-T|--BX----TX----BB||T---BXTXTT-|-BT-T--X-TBTT-|TT---|
m------XBXB---|--XE---B--E-E-B-B-oB||X-|E|-|BBXX-EXE--X--X-|-|B-EXBX---X||-|X|B-|-||X---EE--||X--E||-|XX-|XE-E-|XB|oX||XE---|---X-XX|E-|---|X-|X-X-||-B-X--BE|X-B--o-|||E---X|X||-|BX|-|EBX-|-||B|||B--T
XXXXXXXXXXXXXXXXXXXXXXXXXXXXXXXXXXXXXXXXXXXXXXXXXXXXXXXXXXXXXXXXXXXXXXXXXXXXXXXXXXXXXXXXXXXXXXXXXXXXXXXXXXXXXXXXXXXXXXXXXXXXXXXXXXXXXXXXXXXXXXXXXXXXXXXXXXXXXXXXXXXXXXXXXXXXXXXXXXXXXXXXXXXXXXXXXXXXXXXX
