B-------------B-----B--BB---?--------M--B------B----B------E-------------B---------------B--B---o-B---------------------------BB---B--E--------B---------E-------------o?---------B-----B----------B--B-
E--B--------------B---B-M---B------------?-----------------B-----oM-----------B-------------?o--------?--B-B--------------------B--B--B-------B--B-------B-B---B-B-B--??--E-B----------B---------------B
|B--B----?-----B--B-----------------B-------------o---------o-----BB--B----BBB---------------?B-----B--------E--?--BEo----B----------B----BB-----------M----B--BM--------BB--B----o-BB----------B------|
E-----B-------B-----------B---------E--B-B--------------B--------BB-----------------B-----?----------B---B-B-B--B---B---E?---B----------?---?--------o---B-----------B------------------EB-B-Bo----B---E
|--------B---------------?---B------B--------------o?-?-----o----E-B--?B-B-------B----M----?------o----------B---------?B------------B-E--?--------------E-B---------------------o-?B---B-----------o--|
|---B---------------?---------B---------------B----------B-------B--------B-B-------B---B----------------?-----------------------------B-------?B--B-----B----------------------------------BB---------T
E----------B--o-B-?-----------------------?----------------------------------------------------------------------------------------B-------E----??--------------?-EB-B-------------------?---o-B----?o-B
B---M--------M-------?---?-----------------------BE---------------B-------B-----------------?-----BB----B-----B---M--?B---------?----------B----------B-----------B--B---B---?--------?-----?B-----o---v
X---------B------------------B----B?-----o------BBB--o--B-------------EB--------B-------B-----------------?----------B-oB-------B------------------B-----------B--B---------B----B-B----B-B---o--------|
X-B-------B---B-----B------B-----------------B----------------B-------B----------B------------M-----------------------------?---B---B-B-B--------B-------------B?B----------------------------?-B------|
------B-B--?-B-B---BB--oB---T-?-----E---B----o-----------------B-------B---B-B---------------o-EE------M-M--------------------------?-----------------B---B--o--------?----------B-------?TM-B-----B-BBX
----B-----------------------|---BT--B---------?---?--------------M-----BB-------BB-B-----?-----BB-Bo------B-?-----------T--------?B---o-B-------------------B----B---------T---B---------B|---------T--X
X--B--T---TB---E-----------B|-B--|-B-----------B----------E-----------?-----T-B-----B-EB---------B--o-T----?--BTB---T-T-|-----T----T-B----T----T--T---T----X---------------|-----T-T------|----B-B-B|B-|
|T-T--|---|X-EBB-TT----XBo--X----|-T-TT----------T--------B-T------TT-o--B-B|--TT--T--X------BT---TBT-|-o--T--X|B-T-|-|-|-EBXo|----|XT---T|B--B|-T|--B|----XT--T-----------|----T|-|-B-E--|--B-----X|X-|
m|-|XE|--B|X-B---||XE--X----X--E-|-|-||-X---XEB-E|-XB------E|-oo-BB||----E--X-B||--|EXX------E|---|E|-X----|-EXXB-|-|-|-X-XXX-|--o-XX|--E||----|-||--XX-E-BX|BE|BBE----B---|E---|X-|E--B--Xo--E--B-XXXXX
XXXXXXXXXXXXXXXXXXXXXXXXXXXXXXXXXXXXXXXXXXXXXXXXXXXXXXXXXXXXXXXXXXXXXXXXXXXXXXXXXXXXXXXXXXXXXXXXXXXXXXXXXXXXXXXXXXXXXXXXXXXXXXXXXXXXXXXXXXXXXXXXXXXXXXXXXXXXXXXXXXXXXXXXXXXXXXXXXXXXXXXXXXXXXXXXXXXXXXXX
