E-------------------------------B------------o-BB-----------?-------M--B-B--B----?---BB-----B--B-o--B-----------------B-----B---------------------------------------B---B-B---?--o-----B--B------B-----|
T----------B--------------------------------B-B---B----M--------------B---------------------------E--------------------B--------B--------------------------B---------B---------------------------------T
----B-?-B-----B--------o------B----------------B----------------E------B-------------------o--B---B------------------------------?----B---E--------B------o----------B--------------------E----B-----B-E
XB---B--------B---B-----B-------------------------B-------------B------------B---------o---B-B?--BB----B---B--------B-----------------M---BB------o------B----------------o------B-M----B-B--B-----o---T
B-----E------o--B------------M----BE---B------B-------B----------------------------??------------------B---BB------E---?----------------------BB-----?--B--B------B--B---B----------B---o--B?---------BX
X-----B-----??------?-B------------B--------------------B------B-------------BB------B------------B--------B---M---B----------------------------?--B--B----------------B-------------------------------X
?-------------B-o----?----B-?---B---B-B-----M-------B-----B--------------B------------------------------B-----------B--------o?--------?----B---------o----------------B----?----B-------------B-B-?---|
T------B--o--------?---B----------------B-------B--B--?--------------------------B--------B-------------------oB---o----B----E--------B--------?--------?-?--------M-B-----------B---------------------v
EB--------B-B---BB--B------B-?---------?--B-----B----------------B--B---------------M-------------B----------M----B---B------B-B-B----M-------------------------?-----------------B----BB-----------o--E
|----M-B-------------------------------o-----B-----BB-------------------B--------?---------B--------------------------------------------------B-------BE--B----B--B-------------------BB-B------B---?--|
----?-B-----E---?---------B-------B-----B---------------B-------B--B--?--------T----B------B?-------------B------------?------B--------------B-------B-B----------B------------o-----------------------|
X------B----B-?-B--B---T---------------E-------B-----------?----B-T-------?T---|--------B-B----B---B-----o-TB------B--B-----------o-------------TB-----------?------T-B?--B-----B----------o?----E-E---X
---------B------------M|-----B?--------B---------?------TT-----ME-|--oT----|-B-|--T-T-T----------X---T---BT|--B?-----BT---------?-------T-------|--T?------X-T------|--o--B-B-----T-----?-----B-BB-X-BB|
X---------o---TBB----T-X-----TB-B--T-T----T-E-B----E----||T-----B-X--X|T-TT|--T|--|-|-|--BB--T--XX---|----||T-XB--B-o-|--XT--T--B-------|-B-B---X--|B--T--BX-|------|B---B-TB-T---|--T---T----T-BB-X---T
mE---E---B--BB|BB----|-X---E-|---E-|-|----|-B--X-B-X----|||-E----EXo-XX|-||XE-||--|-|-|---E-B|oEXXE-EXE---X||EX-E-E---|X-X|-E|E-E-B-B---X------BX--X---|B-XXBXXE----X----BX|--|X-B|BE|E--|--E-|----XB--X
XXXXXXXXXXXXXXXXXXXXXXXXXXXXXXXXXXXXXXXXXXXXXXXXXXXXXXXXXXXXXXXXXXXXXXXXXXXXXXXXXXXXXXXXXXXXXXXXXXXXXXXXXXXXXXXXXXXXXXXXXXXXXXXXXXXXXXXXXXXXXXXXXXXXXXXXXXXXXXXXXXXXXXXXXXXXXXXXXXXXXXXXXXXXXXXXXXXXXXXX
