T------o-----------------------------o--BB----------o--------------------B-----o---o------B---o---------------------B-B------o------------------------------o-o----------Bo---B---B----------o---------X
------o----o--------------------o---------------------B------o------------------B-----------o---------o--o--o------------o--------------B------------Bo---------------------------------B--------o-----E
------B----o---o-----------o--oo----o---oo-------------oB------------------o-----o-------Bo---------------------------B-o------o------o--------Bo--B-o---------oBB--------------------------B--------B-o
---------o--B--------------o----------------------------------------B--------oo---o--------B-------------B-------Bo-----------BB---B-----B--------B------------o----B------------o----B-----------B----M
?---------B---------o-------------------------------------------o---B---------------oo------------o--B-B-o-B--oB----B--B----B---o----B----BB--------o---------Bo----B---B-----------------B------------|
M---------o---------------BB--------o-----B-------------B-------o-----------------------------o-------B-------------------B-----B--------------------BB------B-----------------o--o-------o----BoB-----B
--o-------B--B-----------------------------o--------B-------B---------B---B---------o--------MB-----------------BB---------BBB-------o--B------B------B-------------B--o--------------o----------------E
|--------B------B--o----oB--------o----o-----------------------oo------------o--------B--B-B-----------B---------o-oo-----------Bo-----------------o-------------B-------B-B------o-----------B-----Bo-v
---o------o----------------------------BB-----------o----------------B-----B-?-----B---------------------------------B------o---------------------------------B------B--------B-----o----B---------o----
|?-B-------------oB----------------o-------B--------------o----------B-------------------M---B--B---?--------------------------o----------------B--------------B------oooB-----B--B--B---Bo------o-----|
|-----------------o-----TB-----B---B------B-----------B--B--B-B--M-------BB-B---------------?B--B------------------T---------B---BB-B--T-B----------o--B----B------o------o--B----o-o------------------|
B-----M-----?-------BM--|-M------o-----------B--?------o-B-----------oo----------B--------------o------M----?---?--|------M------------|----------M--Bo?-------------o--B--o-T----------oo-M--o------?-M
X----M-----------?-o----|--------oT----BT----T----B-B---------?B-T---TBo------?----o-?----Too-?-oM-?-----oo-oT--o--|-B-T-M-------------|--B--o------?-------?--?----?-To-Mo-T|BM------?M---B-----------B
M-------?---------------|--o---B--|---??|----|T-o-------?--------|---|---T-----?---o----M-|o-------B?T-?T---B|o---B|---|T-M---T--XMTB--|--T--o---M---B------B------oB-|--B?-||------------T----B--o----|
m-o-oE--EB---B-B---o---E|o--X-----|B-o--|B---||E-B--B-BE-------oXX---|---|X--o-E-X--o-----X-X--oo-B--|-B|--Xo|--X--|-E-X|---B-|E-X-|---|--|-E----------o---BX-B-B---o-|-----||--EBE-B-o---|E-X--X--B---|
XXXXXXXXXXXXXXXXXXXXXXXXXXXXXXXXXXXXXXXXXXXXXXXXXXXXXXXXXXXXXXXXXXXXXXXXXXXXXXXXXXXXXXXXXXXXXXXXXXXXXXXXXXXXXXXXXXXXXXXXXXXXXXXXXXXXXXXXXXXXXXXXXXXXXXXXXXXXXXXXXXXXXXXXXXXXXXXXXXXXXXXXXXXXXXXXXXXXXXXX
