X--E--------B-----------B--B--------B---------BB---?--?------------------------B---------------E-------------B--?-------B-o---B-?--------B-----?--------------------------M--------------B----------BE-T
|--B----------B---------B-----BB--B--------B------B----B--B--B----------B-o------B---B---------B-B------------?----------?-------------B--EB-----E---B-------------------------?--BBB---B?---------B-B-X
E---------?---BB--------B----?----E-------------BB--------------------------B----?--B--------o------------------B-?-o--B------------------B------B---B--------EB---------B------?----B----BB-----------X
M-------E-----------o-------------B-B-------------B-?-------?----------BB------B---M-B?-o-B--BB---B-----?-----B----B------B---o--B-B-----B---E----------------B-oB---------------------------B---B--B--|
|----?--B----------B-B---------BB-?---------------------------B-------EB--o?--B----B-B------B---E--------B-----B------B-------B-B-B-o--------BB-----------------B-B-----B--o----------------------B----X
X-----B--------B----o----M---?-B------E-B--------B-B-------------?E---B----------?-------------BBBB?B--------B-----------E---o-------------?----B-------B------------B---------------------B-----------T
X?-E--Bo-B----M----------------B--B---B----?--B-----------B-BM----B-------------B------B---B-----------B---------?--M----B--------B---B-----B--B---B-----B-B------B--------?----------------------?-B--T
---B--------------B--------o-------------B---------B--BEM-----------E---o---o----E---B-B----------BB----------B-B--------B---B--BM-B--B--------------B-------?------------------E-------E----B-------B-v
----------B-B-E-----------?--------o?-BB---B--------BB-B------------B------------B?-o---?--------------------B-----------------------------?-o--------B---B----BB-o------------MB-----?-B------------B-E
X--B----------B-B--B---B---------------Eo-B--B--o---E------------o---B-----MB--E-----------B---------??--B-------B----B-B-------E-B-------E---B------o--------B----------M-B-----------B---?-----------X
X--------?---o-----------------B-------B---o--------B---------BB--o------------BB----B-----B---------------B--?---T------------oB-------T-B-----------B---B-------------------o---------------B----?---B
T-M---------------------?---------------?-B--------Bo--E------------------?--BB------B---B------------o-?---------|------------?--------|----------?-T----B---------TT-------BBBo?---?B----------B-B---?
|-B-----?--o-----BT---T----------?------B-------T------B-------B-T-----E-BB----o---T--M-EB--B----TT-XB--T---MB----|-------------B-T--B--|------------|-E------------||-----E--T----T-BT------?----------
X--B-BX--E-TB-----|---|-----T-------TT-E--T----T|---T---TX-------|-----B-B--T----T-|----XT-------||-X---|T-----X-TX-o-----------BT|-B---|E-------X---|TX--T-------T-XX-----BBT|----|--|-----T-T-T----T-|
m-B-B-X--XB|o-E---|-B-X-X---|----E--||EXE-|B---|X---|---|X------E|-EB----B--|-EE-|-X---EX|--EE-B-XX-XX-B||-----X-|X-B-EX---E-E--X|X-----XB--E----X---||X-B|--E-B--|EXX---EE--||X--EX-E|---BE|B|B|--B-|-X
XXXXXXXXXXXXXXXXXXXXXXXXXXXXXXXXXXXXXXXXXXXXXXXXXXXXXXXXXXXXXXXXXXXXXXXXXXXXXXXXXXXXXXXXXXXXXXXXXXXXXXXXXXXXXXXXXXXXXXXXXXXXXXXXXXXXXXXXXXXXXXXXXXXXXXXXXXXXXXXXXXXXXXXXXXXXXXXXXXXXXXXXXXXXXXXXXXXXXXXX
