X---B---------B-B------------------MB--?-------------------M--M---B-----B------------------BB------B----------------------------B-B----BB-----------B------B---B--------B--B-B-B----------B------------X
B--------o--M----B----------M-------------B---------------------B-------B----B------B------------------BBB-----B----B---?---------------------B-B---M-B-------------B------BB------------------------o-X
|-----B------B-------------------B-----o------B---------o-----------------M-------E----?----B----------------------?-------------B-------------B---------B----B-------B------------------o-B---B-------|
X-----------B-----B----B-----B----------------B-------------------B-----------B---B--E----oB--B-------------B-----o---------------------o--BB--------B---------B------B-BB-------B-B------B------------X
E--------?---------------?---M--EB---------------------------?M----------------------B-B-B-----o------B----------oB------?-------Bo----------------B---------B-------B----?-o?---------B-B-------------X
X----------------?-------------BB---?o---E------------------------?--B--------o----B----------------B----------B-------------B---?---------B--?---------BB-o-----------B-----------------------o-------X
E-B----B-----B--B-----------------B----E-BB------B?---------------------------B---B--B-B---------------------B--B-----------B--B----oB------BB-?------?-B-----B-----B---B--B--BB---------B?------B---B--
E-----------------------B---------B----B?--------B-----------?--------------oB--------------B----o-----B----------------------------------------------------------------B------------B-----------------v
|-------o-----E--------------B------------------B----o---??B--B---?------------B---------B---B------------B---------B---------------M---o--B------?o------------------B----?-B--B---------B------B-B-?-X
X-------------B----B-------------?--B---------B--E---------------B-----B---B---------------B------------------B---M---------B---BM----E-B--M-M-------------E---B-oB?---------B------B-------B----------T
X----------------o----BT---------o--B-------?----B---B----B--oE------B---B-B-----B----?-??-----B?---------B-----B---------------------B---?----B----B-o----B-----------o-------------B--?---------B-----
|-------------------?--|------------B-----B----------------B--B--------B-B-------E------------?----------?-BE--B-----o--------B----------B--B----BB?-----T-BBBETT------?---B----?---T----B--B----------X
X---T-T-?----B---B---TT|B---TTB--------T---------------B--------------T-----BT---BB-----TT?-T---T----B---B--B-----------B------T--------------------TEB-T|-?--B||--------?-B----B-B-|-------X-T----B---X
-B--|-|-T-------T--T-||X--B-||--T----T-|----X-oT--E-TETB-T--B-TBB-T---|-----T|--B-T-----||--|---|B-o--B---------B--B-------T---|-o--EE--------T-T-XB|X-T||---T-||-X-B---B-o-T--T-B--|ETT--BTX-|TTT--TE-X
mX-E|-|-|-------|--|-X|X----XX-B|--E-|X|o--XXE-|--B-|X|XB|EEB-|--E|--E|-----||-B--|-E-o-XXE-|-B-|E---B-EE-----E--EX-XE-----|---|----BX----B--B|-|-X-|X-||X-B-|-X|-XB---EX-E-|--|--BEXB||-BX|X-||||EB|B-B
XXXXXXXXXXXXXXXXXXXXXXXXXXXXXXXXXXXXXXXXXXXXXXXXXXXXXXXXXXXXXXXXXXXXXXXXXXXXXXXXXXXXXXXXXXXXXXXXXXXXXXXXXXXXXXXXXXXXXXXXXXXXXXXXXXXXXXXXXXXXXXXXXXXXXXXXXXXXXXXXXXXXXXXXXXXXXXXXXXXXXXXXXXXXXXXXXXXXXXXX
