E-----o---------o---------o---B--------B----------------o----B-----------------------B-B---B---------o-B---------o-o------------B---------o--B-------------------B-------B-----------------------BB----B
-B---------------B-------------B-------------B----------------o----------------B----------o-------------------------o----o-------------------------------------------o--o--------------o---------------X
E------B-----o-o-o-------------B----B--------------o---o---------------o---o----------------o----------------B--------o---------------------------B--o-----------------------B--------B----------------M
X------------B---------B--------------------------B--o---------------------B------o-----B--------o---------------------------B----BB---o---------B----B---------o-------------------------------o-----BB
?--o----------------------------------B------o-----B------o------------------------B-----------------o-------------------Bo--o---------------B----------------------B---B---------------o-----B--------T
Eo-o--------------o-o---BB--------o-------------------o-B---------B-o----------------o----------------------------o-------B------------B-B---o--B---o-----B--B-----------------o--o-----B--------------X
M------------B---B--------o-----------B-------------------------B---------oo------B--------------------------B-o------B--------B-----------------------------------------B-o--------------B----B-------?
E-------o----------------BBBB--------Boo------B---o--------------B-----o-M---------------B----------o--------B-BB------Bo-----B-------------------M------------------------B-------------B-?o-----o-o-Bv
o--B-o-----o---B---B------------------------------B------------------B----Bo--B--------B-B--o-oo--o-------o-----oBo-T---------B----------------B-o-B-----------------B---o-oB-------------o-B------o---|
|--o----o--o-------------T---B-------M-----------------o?----------o--------------B-----------o--?-----o?---o-------|---------o---B----B-B--------------B--------o-------------------B---------oM--oBB-X
E--B----------B----------|-o--o------B---o------o--o--------B----T--?----BB-------o-----B--------B----------------oB|--------------------------Bo-----o-------o----------------T-B-B-o-T-------BoB-o--M|
B--o-------T----Mo---o---|MB--BM----B-o---BB----M------M-B--o----|-------?--M-B----B------o----M-------o----?-------|M---?T-B---B-----T------------?-B-T-------?M?--M-----B--?-|------o|-oTM---------oBX
----------B|--T--------M-|B---------------------o--B-o--?--------|--o-B----?-o--------------o------?-M---oo----??---|--?o-|---?------o|----M--------?--|-?o-----------------B--|-------|-?|B--BTB--B---M
?---B--M---|--|---?-----B|?----B---M?o-----------o-----?-----B---|-------o-------B--o-o--Mo---T---T----BT--B-T---B--|-----|-----BT-B--|---T--T----B-B--|-B------MM--------B----|----?--|--|----|B?-?---B
m-o-----E--|-X|----------|-B--o-o---E-XB---X----E-oo---E---X--E--|-X----X-B------X------------|---|-----|----|E-o---|-----|--E-o-|----|-X-|--|X--------|--B-------Bo-XB--------|XX-B---|EE|o---|----BB-T
XXXXXXXXXXXXXXXXXXXXXXXXXXXXXXXXXXXXXXXXXXXXXXXXXXXXXXXXXXXXXXXXXXXXXXXXXXXXXXXXXXXXXXXXXXXXXXXXXXXXXXXXXXXXXXXXXXXXXXXXXXXXXXXXXXXXXXXXXXXXXXXXXXXXXXXXXXXXXXXXXXXXXXXXXXXXXXXXXXXXXXXXXXXXXXXXXXXXXXXX
