------------------------------------------------------------------M-------------------------------------------------------------------------------------------------------------------------------------
-----------------------------------------------------------------------------------XXXXX----------------------------------------------------------------------------------------------------------------
--------------------------------------------------------------------------------------------------------------------------------------------------------------------------------------------------------
--------------------------------------------------------------------------------------------------------------------------------------------------------------------------------------------------------
--------------------------------------------------------------------------------------------------------------------------------------------------------------------------------------------------------
--------------------------------------------------------------------------------------------------------------------------------------------------------------------------------------------------------
--------------------------------------------------------------------------------------------------------------------------------------------------------------------------------------------------------
---------------------------------------------------------------------------------------------------------------------------------------------------------------------------------------X---------------v
--------o----------------------------------------------------------------------------------------------------------------------------------------------------------------------------------------------f
------------------------------???----------------------------------------------------------------------------------------------------------------------------------------------------------------------f
----------------------------------------------------------------------------------------------------------------------------------------------------???????--------------------------------------------f
------------------------------------------------------------T------------------------------------------------------------------------------------------------------------------------------------------f
----------------------------------------------------------X-|------------------------------------------------------------------------------------------------------------------------------------------f
-----------T------------------------------------------------|------------------------------------------------------------------------------------------------------------------------------------------f
m---E------|-----------------------X------------------------|--------------XX--------------------------------------------------------------------------------------------------------------------------X
XXXXXXXXXXX|XXXXXXXXXXXXXXXXXXXXXXXXXXXXXXXXXXXXXXXXXXXXXXXX|XXXXXXXXXXXXXXXXXXXXXX------XXXXXXXXXXXXX----XXXXXXXXXXXXXXXXXXXXXXXXXXXXXXXXXXXXXXXXXXXXXXXXXXXXXXXXXXXXXXXXXXXXXXXXXXXXXXXXXXXXXXXXXXXXXX
