---------------------------------------------------------------------------------------M------------------------------------?-------------------------------------------------o----------X--------------
----------------------------------------------------------------------X-----------------------------------------------------------------------------------------X---------------------------------------
-------------------------------------X-----------------------------------------------------------X---------------------------------------BB-------------XXXXXXXX-------------------------------------X--
----------------------------------------------------?-------------o------------T-----o-------------------------------Bo---------------------------------------------------------------------------B-----
----------X---------------------------------------------------------------X----|-----------T---------------T--------------------------------------------------o-----------------------------------------
---------------------------------------------------XXXXXXX---------------XX----|-----------|-------X-------|---------------X------------------------------------------------------------MBBB------------
-------------------------------------------------X------------------????XXXBBBB|BB------o-T|---------------|------o-------XX-o--------------------------------------------?-----------------------------
--------------------------------------------T--------------------X-----XXXX----|----------||------XXXXX----|XXX-----X----XXX--------M----------?-------------------T--------T--X-X---------------------v
-------------T--------XXXXBX----------------|BBBT---------------------XXXXXX---|----------||---------------|--------XX--XXXX------------------X--X-----------------|-----X--|----?--------------------?f
-------------|--------------------T-T-------|?--|-----T--------------XXXXXX---?|----T-----||---------------|---T----XXXXXXXXX--------------------XX----------------|--------|--------------------------f
-------------|--------------------|-|------T|---|-----|-------------XXXXXXX----|----|-----||---------------|---|--X-XXXXXXXX----X---------------XXXX---------------|-M------|--------------------------f
------------M|---B---M------------|-|----o-||---|-----|----------?-XXXXXXXX----|----|-----||---------------|---|-XX-XXXXXXXX---?XX------------X-XXXXX---X----------|--------|-------------T------------f
-------------|---------------BBBBB|B|------||---|-----|-----------XXXXXXXXX----|----|-----||-?----------??-|---|XXX-XXXXXXXX----XXX----------XX?XXXXTX--XX---------|--------|-------------|------------f
-------------|--------------------|-|------||---|-----|----------XXXXXXXXXX----|----|-----||------------M--|---|XXXXXXXXXXXX----XXXX-X------XXX-XXXX|XX-XXX-------o|--------|-------------|------------f
m---------E-E|--------------------|-|-o----||---|-----|-------E-XXXXXXXXXXX----|---E|-----||----E----------|--X|XXXXXXXXXXXX----XXXXXXX--E-XXXXEXXXX|XXXXXXX------E|-E-E----|---E-E-------|EE----------X
XXXXXXXXXXXXX|XXXXX-----XXXXXXX---|-|--XXXX||XX-|-----|---XXX--XXXXXXXXXXXXXXXX|XXXX|XXXXX||----------BB---|XXX|XXXXXXXXXXXXX--XXXXXXXXX--XXXXX-XXXX|XXXXXXXXXXXXXX|-------X|XXX------XXXX|XXXXXXXXX-X-X
