-|?-------------------------------------------------B------B-----------o-----E--B----B----B?--?----BE-----------------------------------------BM--------------------B-----------B------BM-----BB-------X
X|------B----B---------Bo---B--B--o-------B--B----B------------B--o----------B----B---B--o-------oB-B--------------B--------------------------?-----------B-----E-----------E-----------------------E--|
EX-----M---------B--?----?o----------------Bo----o-----------?-o-------B-----B----B----------B-----------------------------------B----------------------B--?B--BB-----------B------------BB--B----B-B--X
oX-B?------------------o--------B------o-----------B---B---------------------B----------B-------------------------BB----B----------------BB----E----B-E-----------------?------------------------------T
XX-----B--------------??----M------o-----BB-----B-?--------------------------o-----------------------------?-----B-B--BE-------B--------------BB-----BB-B--B--------------------B-B-B------------------B
|B----?----------B-----------------B-----B------B----------------------------------------E-E--------BE-o-----B---------B---E---------B----------------------B---o-------B--------B----------------B----E
BE---BB---?-----B-------o--------------------?---------B-------------------?-----B---B---B-BE----?oB-B-?------B-EB-----B-BBB-----------?---------B----------------BM-?--B---------B---------?----?-----E
XX---------?---------------?-------------------------??-BB----------B----B-B----------------B--------B---------BB-------B------B--------B-B---B--B-------B----------B-------------B----------------B---v
X|-B--B-----------E------------B---------B--BB----------oB------B---B----B-----B?-------B--------B----B----------T-BB-B--?------B----------B----------??--------------------------------------B---?--B-X
XT-MTo--BB----B-?-B---------------------BB-B-----B-B--------------------B------o---BBB------X---------------BB-?-|----o----M-------------------B----BB---B---B-B----B-----------------B-?--B-----E-----E
|E--|-----B------------?------------BB----B---------B----------B------------?----------B----X--------------------X-----BB--------?------------------?-----------------------B----------BE---B-B--B-----E
XXB-|---------T----?-------B----?-----T---------T----------------------------B--T-----B-----X----T------E------B-XB-B----B-------B-----------B-------B--B--T-----------B----------B---?-B---------T----X
B|?-|------T--|---TB--B--?--B-B------B|E----B---|------T----B------o-B-?-T--TX-M|----B------X----|B-----B---?-E-BX----------------B-----BT-----------X-M-?-|-T----B---------TB---------T------BB--|--?-X
E|T-XT--TX-|--|---|EEE-T-----E-------TXB------o-|-B----|-T---T---T--Eo---|E-|X--X----BoX-oT-XEB--X--------TB-BX--X--------o---T--X------T|-X---XBE---X---TTX-|----B--B---X--|------BT--|-BT---X---|-----
mX|-X|E-|X-|--X---XXXXB|B-E--BBEE-BX-|X-E--EX-E-XB---B-|-|---|---|--X--E-|X-|X--XE-E-oXX-E|-XXX--X-B--EBB-|XB-X--X---B-BB-E---|B-X-E-B-B|X-X---XXXE--X--E||XE|B---E--BE--X--|EE--E--|X-|-X|---X---|--E-X
XXXXXXXXXXXXXXXXXXXXXXXXXXXXXXXXXXXXXXXXXXXXXXXXXXXXXXXXXXXXXXXXXXXXXXXXXXXXXXXXXXXXXXXXXXXXXXXXXXXXXXXXXXXXXXXXXXXXXXXXXXXXXXXXXXXXXXXXXXXXXXXXXXXXXXXXXXXXXXXXXXXXXXXXXXXXXXXXXXXXXXXXXXXXXXXXXXXXXXXX
