|--B----------B-MB-------B-------B----B----------------------------B------B-------?---B-B-B---B------------------------------B-------o--B------------------------B-------------B---------B----B----?---|
|--------------oo-------o---------------E------B---------E--------------------------BB------B----------E--------?--?--B---?---------------B-----BB-o-----------BE--B-------------------------BB-B------E
|----E-B---B-B-----------------M-----B-BB-E---B-------?--Bo-B-?----------B-----B--------B-B-B----------B--B------BB---------B---------B-----B--------o----------B--?---B--------------B---B-B--------B-B
-----B-?-M----oB--------B?-----B---B----o-B---------E------------------------BB-M-?--?--------B-----------?--B----------B---------------------B--------------B-------B----B-----------B-?-------?--B---B
|---------------B?-----------o--o-----------B-------B-B?----E-----------Bo----------------B---o-?-B------B---B-----E---?----------------B----------------------------oo-B---------B---B---BB--------B-B-
X--?------o----o--B-----B---B----------?-B----B----?-B-B----B-----B--------B----------?----B---B-------------------BB----B---M----------B------------------B-----------B--B----B-----------------------B
B--------?----B--------E------------?----------------------B--B--M-------------------------------?-------B------B?--o------------------B----B------------o-------------?-----------?--o-----B---------BX
X?-----B---------------B--B----------o---------------------?--B------B--?B----B-------------?----E---B-----------------B-B--------------------------B------B-----B------E----?-----BB----B--B-?------B-v
-----E------B--B-----------B-------?---B----?B--B-------------B--------------------------B-------B----B-?---------M--------------B-------?E-----B---------B--B-----M----B--------------E--------E------E
B----B--?o?---------------B-B------B--?-------BBM----------B-------E------B----------M---B---B------E------B?--B--B?----------------------B-----B----------------B-------B-B---B-------B--------BB---o-X
X-B-------------M---?------B---B-----------------B-----------------B--------------B?-E-----B--------B---------B-------E--o-B-------------------B------------------------------B----oB?---B-------?-----E
---------?-----B---T--B---??-B-------------T--EB-----------------------T-B-----------B-------------o---B---B--?B------B--------------------------B---T--?------B------------------T---E-T---------------
|----T-------------|T---------T-T-?--B----B|--B--?B----TBB-------------|-------------B--TB?--B-o-?T?---TB----?-----------B---B-----------------TB??T-|-----?----B-----------?-----|?--B-|-----B--------X
XEB--|---T-BT------X|T-T------|-|-BT-------|B-T-----T--|-E---------TT-BX-T--T---XT------|------XBB|-TT-|TB----B---------B---------T----TB--X-T-|--B|-|----T--T------T--T-----TE---|BB-T-X---TT----TT--TX
mBX-EXE--|-E|-EBEX-X||X|EB-B--XXX--|---o---X-E|-XBX-|--XEX---------||--X-|BE|EX-X|--E--B|-----EXXEX-||E||-----BBE---E-X-----EB---E|B---|---X-|-|---|-|----|-E|E-BE--|-E|--B--|BBBEX---|-X--E||----||--|X
XXXXXXXXXXXXXXXXXXXXXXXXXXXXXXXXXXXXXXXXXXXXXXXXXXXXXXXXXXXXXXXXXXXXXXXXXXXXXXXXXXXXXXXXXXXXXXXXXXXXXXXXXXXXXXXXXXXXXXXXXXXXXXXXXXXXXXXXXXXXXXXXXXXXXXXXXXXXXXXXXXXXXXXXXXXXXXXXXXXXXXXXXXXXXXXXXXXXXXXX
