|--BB---oB--------------B-------------?-?-------B--------B---------?---o----------------B-?--B------B-----o-------------M--------B-----B----o------------B-------oE-----?----------------------?----B---
X--------------B--B-------------------------B-o--B-----------------------------------o----B---------B-----B------------------------------?------------------------B----B------------------------B--BB--B
|---------------B----B---B---B------------?--B-----B----------------?-B---?---------------------------B-----------B----------BB-BB----------B--B-----------?--E--------B----B-BBB-----B---------B---?-MX
|------------------?----B----------------------------------B--------o-?-------------------B-----E--------BB-?B-?----------------------B----------B------------B-------B--------------------------------X
X---------------B---------------BB----?--Bo?----------------------------------------------------B---------------------B----------B----------B?-----o-----B?B-------o-------------------o---------B-----E
|-B-?-B---?-------------------B--B--B--o---------------E----------B?-B-----------------M-----------------------B-----------------?-B-------B-B-----------------?----------??---E-----------------B-----X
B------M--------B------------B------------------?---B--B-oB---------E-M-------B-BB----------------------------?----B-------B--------------------E------------------------o-----B--------B--------B--B--X
XB---------B-----B-BB-----------------------B-B---------------BB----B-----?B----B----------------B--o-------B---B-B-B-B-------?---T---B---------B-----------B-------B------------?---B---------------B-v
X--?---B---------------------E-----B---------B--B--?B--B--------------E-BE----------E--B----B-----------M-------------------E--B--|----------------B-B------?o-------B---?o-E--------------------------B
X------B--E---B-----B----ET--B---------------------E----?-----o-?-----B--B---B---?--B----------B------B-o?------E-----------B--B--|-----------------------------B---------B-B-B---------------------B-EB
T--------BBBE------------B|-----B-------------B----B-------B----BT--B---E---B-?-o----B--B------------B---------oB-------E----M----X------T--B-------B---B-------------B--B--------E---------------B---BX
X-----?---BBB---?----o----|----T----?--?------B---T-------B-B----|------B--B----B-------------------?B---------------T--B--o------X----B-|---------?---T----T---T----------T--X?--B------?----------B--|
TT-----B--------E--T------|----|---T-T--BB--------|-----B--?-----|-B------------T----B----------B-------BTT-T-B-B-T--|?-BB--B-TB--X--?---|-----B-?-BE--|---T|---|--------T-|-BX-E--o-----------o----TT-X
B|--------T----BBTX|------|-BT-|B--|-|T-TBo-TT----|--------BBX--T|B---ET--T-----|-X-B-TET-TB-------E--T--||-|-----|-T|---B----|--TXT---X-|---T--TT--X--|---||BT-|--------|-|B-X-B-T-T-T--T------T--T||-E
mX---B---E|----B-|XX-XEE--X-B|-|---|-||-|X-E||--E-X----BX-B--X--|X---EX|--|-B-X-X-X---|X|-|-------BX--|--X|-|---EEX-|X--E-B--E|--|X|B-oXo|---|-X||--XB-XX--|X-|-|---BEX-B|EX--X---|X|B|--|E--B--|B-|XX-E
XXXXXXXXXXXXXXXXXXXXXXXXXXXXXXXXXXXXXXXXXXXXXXXXXXXXXXXXXXXXXXXXXXXXXXXXXXXXXXXXXXXXXXXXXXXXXXXXXXXXXXXXXXXXXXXXXXXXXXXXXXXXXXXXXXXXXXXXXXXXXXXXXXXXXXXXXXXXXXXXXXXXXXXXXXXXXXXXXXXXXXXXXXXXXXXXXXXXXXXX
