-X?--------------------------B----------------------B--------------B---B--------B---------B---?-----EB-----------------B-------B---B-B-B-----BB--------------------oB--B--------B-------M----?BB-------X
X-------B--------B------o---B-----o-------B-------B---------------oo-o-----------?B---B--------?-BB-B----B-------B-------------------------?--?-----------B----BE--------B--E-----------------------E--|
EX-----------o-----B?----Bo--B--------------o----------------------B-B------------B--------B---------B-----B--------------------------------------------B---B---B-----------B-------------B------oB-B--X
oX--?----------------B----------B?-----------M-----------------B-----B---------B--------B------B-B----------------B-----B------------B---BBB--------B-E-----------------?--------B---B-----------------T
X|-----------B---B----?-----M--------B-o--B--B--B-?------------------B---------------B-------------------B------------B-----------------------B----B--B-B--------B-------o-B-B--BBB-B------------------B
|X----?--------B-----E---------E-----------B----B--------------B---------------?--------------------B----------------------------B--------------------------Bo-oo-------B------------------B------B----E
BX----B---?-----B?---B--o------B-E-------------B-----B-----------------------?--------------E-----o----B---B--B-E--B---?--B--------------B-----------------o------B-----B---------B--------o?--------B-E
XX-------------------------------B--------------------?-B-----------B------------o----------B----B-------E---B--B-------B------B--------B-B--BB----------------B---MB-------------B--------------B-----v
X-----B--------B--E-------------------------B--------o--o--o----B---B----------o?-------BB---M-----B--B--B----------B-B---------B---------------------?----B---------B---------M--------------B---?--?-X
X---T---B----oB-?-B--------B-------B----B--B-----?-B--------------------B?-----B----B-------X--B------------B--B---B-?o------------o----------------B------B---?----B----?-----B------B-?--------------E
||--|-----B----------B-----B-------TB----BB--B------B-----------------------?---------------X--B-----------------------BB------?-B-------------?----?B---------------B-----?B------B----EE-BB-BB-----T-E
XXB-|----B----TB----------------?--|--T----B----T--------------------B-------B-BT-----B-----X----B---M--E---------B-B------------T-------T-?------------B-------------------------B---?-BB--------TB-|-X
BE?E|--------?|--TTE--B-----BTBT---|--|-----B---|--B--------B------T--------T---|------M----X-----B-----B---?-E-B----------------|B?----B|---B-------T-------E----B------B--T----B------------B--T|--|-X
EETBX--TTB-T--|--||BE--E-T---|-|---|--X-------o-|-B----T-----------|E-----E-|T-oXT---Bo---T-XTBT-T---E----T---XB----------oo--To-X-B----TX------B----|---TT--X-B--B--B------|--T----T-----T---X--||--X--
mX|XX-E||X-|--X--XX-X-BXB|EB-|B|E-B|-XXEEE--XoE-X--B-X-|-B---E-----|XE---EX-||--X|-E-XX---|BX|X|-|---XE-BB|-B-XB-o---E--B-E--E|--X-E-E--|X------X-E--|-EE||-EXBX--E---E-----|BE|----|--E--|---XX-X|--X-X
X|XXXXXXXXXXXXXXXXXXXXXXXXXXXXXXXXXXXXXXXXXXXXXXXXXXXXXXXXXXXXXXXXXXXXXXXXXXXXXXXXXXXXXXXXXXXXXXXXXXXXXXXXXXXXXXXXXXXXXXXXXXXXXXXXXXXXXXXXXXXXXXXXXXXXXXXXXXXXXXXXXXXXXXXXXXXXXXXXXXXXXXXXXXXXXXXXXXXXXX
