E-----EB--------B----BB-----B-?-----------?----B------------B---------B-----B---B--B--?----B----------------B---B----------------------------------------------?E------------?---------?-----B---------T
Eo-B-MBB-----------?---B-----------?---------Bo------------o--B------?--B----B--------B--------B-----------------B-----------B----------Eo----EBB--B---------?--BB-BB------?----E?----E----------------X
XE--B--------o----?----B---------B-----------B---B?-------------------------------------------BB-B--B?-B----------------------------B--BB-----B--------------------B--BBo-------B--E--B------B--M------X
|X-------------------E----B----------B--------------B----M-----E--B---------?o--------?-----o-B---------B------o------B----B---BBBB------B--B--------------------M--B-B--?---------B----E--------------X
XX-----B-------------B------B----------B-----------------B-----B---B--B----B-------------------------------B-B---B--------o----?------?o---------B---B---------------E?----------------?BB-------------X
|X----B--?----B--B---------B----?----------BBoB--B----------------B-B---------o------------------------E---------------?---B---o------E----------o--------B-----B----B----?B------B-------B---o--------E
BE--B----B---------B--B-B----------------------B-----------------B----------B----------B--o--B------B--B--?-------o---?-B----B---EB---B-----------------B-B----M-------------B--------B---------B------X
XB----------o--B-B---------?------B----?--?--------?-------------------M---------?-------------MoB---o----------o?-?----------?--B-----------o----E-----E----------------M-----B-------------B---------v
|X--------------------B----B--?--------------------B------B--------------------------B---oB-------------------?---M----BB-B----------------T------Bo----B---B------E--?------BB---B-o---B-----------M--E
X?---EB---B-----B---B--B--------?----------------------------B-o---B----o-----------?-------------------------B--E--B-------B---------B----|--?---B----E-----------B--B---B---B--------M------------o--E
|----B---------------o---T---------------------------------E--BB----?--------B-----?----B---------?--------------B----?--M-----------------|-----------B-------------B--B-------------------o-TB-------|
XM--------E--------------|----B-----B--------T--B?---B---B-B----------B---------B-T--B-------?----o-----B-o---XE----B---B---------B?-------|-----?--?B-----X-?----T----------------T----------|-----M--|
Xo-B---B-BB---B-T-------T|-------B--??---B-?-|-------------------B-------BM---BE--|---T--------MT----T-B-----BXB--E------B----T--B----T---BX--?------T-B---X----T-|---------------?|----------|-----B--X
ET---BE---B-X-BT|-----T-||----BTE---o-B-T-T--|---B---B--TBEE---------T---T----TX--|---|---E-E---|T---|-----T--X-TBX-----ET----|-T-----|-B--X--T------|BXTo-X----|-|TT---T-T--B-----|-------B--|-BT-----|
mEXX--X---E-XE-||---B-|EXX-X-EB|BEoB---B|-|--XBE----EE-X|XXB-------B-|---|--E-|XE-X--o|EE-X-X---X|--B|-B-B-|--XE|-X---BBB|--E-|E|---X-|BX-XXE-|X-----XXX|--XB---|E|||---|-|B-E----E|oXE---E--oXE-|---EBX
XXXXXXXXXXXXXXXXXXXXXXXXXXXXXXXXXXXXXXXXXXXXXXXXXXXXXXXXXXXXXXXXXXXXXXXXXXXXXXXXXXXXXXXXXXXXXXXXXXXXXXXXXXXXXXXXXXXXXXXXXXXXXXXXXXXXXXXXXXXXXXXXXXXXXXXXXXXXXXXXXXXXXXXXXXXXXXXXXXXXXXXXXXXXXXXXXXXXXXXX
