---------------------------------------------------------------------------------------M--------------------X---------------?---------------------------------------------------------------------------
--------------------------------------------------------------------------------------------------------------------------------------------------------------------------------------------------------
-------------------------------------X-----------------------------------------------------------X---------------------------------------BB-------------------------------------------------------------
----------------------------------------------------?--------------------------T-----o--------------------------------o---------------------------------------------------------------------------------
----------X--------------------------------------------------------------------|-----------T------------------------------------------------------------------------------------------------------------
---------------------------------------------------XXXXXXX---------------------|-----------|-------X-------------------------BBBBBB---------------------------------------------------------------------
-------------------------------------------------X------------------??????BBBBB|BB------o-T|-----T----------------o-------------------------------------------------------------------------------------
--------------------------------------------T----------------------------------|----------||-----|XXXXX-------------X---------------M------------------------------------------------------------------v
-------------T--------XXXXBX----------------|BBBT------------------------------|----------||-----|----------------T-XX------------------------X--X-----------------------------------------------------f
-------------|--------------------T-T-------|?--|-----T-----------------------?|----T-----||-----|-------------T--|-XXX--------------------------XX----------------------------------------------------f
-------------|--------------------|-|------T|---|-----|------------------------|----|-----||-----|-------------|--|-XXXX-M------X----------------XXX---------------------------------------------------f
------------M|---B---M------------|-|----o-||---|-----|------------------------|----|-----||-----|-------------|--|-XXXXX----T-?XX---------------XXXX--------------------------------------------------f
-------------|---------------BBBBB|B|------||---|-----|------------------------|----|-----||-----|------??-----|--|-XXXXXX---|--XXX-----------???XXXXX-------------------------------------------------f
-------------|--------------------|-|------||---|-----|------------------------|----|-----||-----|------M------|--|-XXXXXXX--|--XXXX----X--------XXXXXX------------------------------------------------f
m---------E-E|--------------------|-|-o----||---|-----|-------E-?-----E--------|----|-----||----E|-------------|--|-XXXXXXXX-|--XXXXX-E--E-------XXXXXXX---------------E-------------------------------X
XXXXXXXXXXXXX|XXXXX-----XXXXXXX---|-|--XXXX||XX-|-----|---XXXXXXXX---XXXXXXXXXX|XXXX|XXXXX||-----|----------XXX|X-|-XXXXXXXXX|--XXXXXX------X---XXXXXXXXXXXXXXXXXXXXXXXXXXXXXXXXXXXXXXXXXXXXXXXXXXXXXXXX
