E---------------?-------B----------------?----M---------B------M---o?--------?--Bo-----E--E-----B------o-E-----B-----------------------B----B-B-----------o----------B--------------------------?------X
|----B------B------------------------------E-M---------------------------Bo------------B--B-----------o--B----------------o------------B-----B----------------B-?-BE?-------------B--B--BBB-----------EX
X----o---B-----------B------E------B-------B-----?B-B---------------B----?-------------------------BB---------------BBM-B--B-MB-----------------------?------?-----B---B-B-----B------------?---------BB
|-B-------------------------B----B-M----B--o---------B------------o-----o--B-----B---?-------BoB-----------B---B--------B-------?--------------------B--------E----B--o------------o---------B---------B
|--?---BMBB-----------BB-------------------?-------B----o-------------------------------o---?--Eo----------B-B-----B-------------B------E?-?------------------B---------B-----------B-B---B-------------
BEBo--------B-----BB?-------?----B----------B---B--------------------------B-B------?--------B-B-?----E------------------E--B------B----B----------------------------------o--BB----------B-------o--EBB
XB--------------B-----B-E-------?---o---------B---------B-B-----B-------BB--------B----------B------B-B-------o--?-------B-----B-------------BB----B-----------B---------------?----------?----------BBB
XB-----------M---?------B-o-------------------------B---------------E----?----B-------?--?-B------------------B----------------------BB--------B-?----B?----B--B-B--------------E-----B-E?-?--B--------v
|------T-----------------B------------BBB---B-----o-----o---------B-BB-----------B--o--------------?--------o-------------------?--E------B?--B---B-o---E-----BB----------------B-o-----B--------------E
BB-----|----B--------------------------B---------------------------B------------B-B-B-----------?---M--B--B------T-?-B---B---------B--------------------B---B------TB-B-----------BB--------B--MB------X
|------X--?----E----B-----B-?-----------------?----B-----BB----B-B---T-B------------o-B--BB---------B----B-------|---------BB----E---M-----B----E---------------B--|--B--------?------BT--------B----B-|
T------X-------B-B---?--------------B------------------M--B------?---|---------------------------B--B---------B--XETT---------E-BB-B------B-----B------EB---------B|------------B----?-|-------------B-X
E---B--X-E-M-----B-----X--------?----E-E--------BT-T--------T-----o--|---B------oB-T----------B----E-----T--B----XB||-B-B-T-T-B-T-------------T------?-B-----?-?-T-|--?---?------------XT-?B--T--------X
Bo---B-X-BT------------X---------TT--X-XB-E--TT--|-|-B---T--|TT------|-T--T--TT----|--TTB------EBT-B--BT-|----T-BX-XX-T-T-|T|--T|oB-------TT--|--------T---------|-|-T---TT--T--T-----EX|---E-|X----o--|
m-B--B-X-E|----B----EE-X----B----||--X-X-EX--||BBX-X---B-|--|||-B----XE|-B|B-||E--BX--||---o-B-X-|-----|E|-BEE|-BX-XX-|-|-||XXB||--o-E----||--|EB----B-|o--B-E---XEX-|-EX||-B|--|----EBX|--EX-|X----B--X
XXXXXXXXXXXXXXXXXXXXXXXXXXXXXXXXXXXXXXXXXXXXXXXXXXXXXXXXXXXXXXXXXXXXXXXXXXXXXXXXXXXXXXXXXXXXXXXXXXXXXXXXXXXXXXXXXXXXXXXXXXXXXXXXXXXXXXXXXXXXXXXXXXXXXXXXXXXXXXXXXXXXXXXXXXXXXXXXXXXXXXXXXXXXXXXXXXXXXXXX
