------------------------------------------------------------------------?-----M-------------------------------------------------------------------------------------------------------------------------
----------------------------------------------------------------------X-------------------X-------------------------------------------------------------------------------------------------------------
-------------------------------------------------------------------------------------------------------------o------------------------------------------------------------------------------------------
---------------------------------------XXXXX--------?---------------------------------------------------------------------------------------------------------------------------------------------------
----------X--------------------------------------------------?------------------------------------------------------------------------------------------------------------------------------------------
-------------------------------------------------------------T----------B----M--------------------------------------------------------------XXXXX-------------------------------------------------------
-------------------------------------------------------------|------------------------------------------------------------------------------------------------B-----------------------------------------
-----------------------------------------------------?----M--|------T-------------------------------M-----------------------------------????????-------------------------------------------------------v
-------------T--------------------------------------------T--|------|-XXXX----------------------X-----------------T---------------------------X--------------------------X---o-------------------------f
-------------|--------------------------------------------|--|------|---------?------------XXBBBBBB---------------|------------------------------------------------------------------------------------f
-------------|-----------------------------T--------------|--|------|---???--------B------------------------------|------------------------------------------------------------------------------------f
------------M|---X---M---------------------|--------------|--|------|-----------------------------------------X---|------------------------X-----------------------------------------------?-----------f
-------------|--------------------------T--|--------------|--|------|----------------------------------------XX---|------------------------T-----------------------------------------------------------f
-----X-------|--------------------------|--|--------------|--|------|----------------M----------------------XXX---|------------------------|----------------------o------------------------------------f
m---XX------E|o-------------------------|--|-E------------|--|----E-|--------X-----------------------------XXXXE--|-------------------E----|--??E?E??---------------------BBB--------------------------X
XXXXXXXXXX---|---XXXXXXXXXXXXXXXXXXXXXXX|XX|XXX------XXXXX|XX|XX--X-|X-------XXXXXXX-------XXXXXX---XXXXXXXXXXX---|-----XXXXXXXXXXXXX------|XX---------XXXXXXXXXX------------XXXXXXXXXXXXXXXXXXXXXXXXXXX
