--o----o-B-o---Bo-B--B----o--------oB-------o-------------o--B-----B-----B-B-o------B-B-o------------------o-----o-o--------o--o---B---o---B------o----------o-B----------o----------oB--o-B--o---B-----
-B---o-----o------o---------------B--------------------------oo-----------------------------o---Bo--------o------------------------B-B----B------o---B-------------o------B------o------B----------o----
-o-o---------o-o-B-----B------------o--------B-B--B---o------B----B--B------o--o------------------o-----B--B----B----o-------------B--B-------------------------Bo---o--------o-------o----o----------B-
---B-o----B------------B---oB------------B----------o---------------B--B-------o--B--------B---B----o--------BB--B--B---o---B--oo--o--B--B--B-------B--o-B--o--B-----o---o-------o--B--o---B------B---B-
---B-B----B---o--B---o-B----o--B--------o-------o---------------o----o---o----------o----------------B------B----------------o-------B---o-B--BBo-----B------o----B---B----------B----------------------
---oo------------------B-B----B-B--BB-----------M-----B----------oB-o-----BB----------------o---------o--------o----------B------------B---o-------o---------oo---------Bo--oB---------o-----BB---------
---------B----------B--B------------o----------------------B----B--B---------o------------------------oo----o-o----o--B-B----o----o-------B----------o--M--B-------oB------B------B---o---------o---o---
-----------B-----B--B------o--------o---o----oo----o---------------------B---o--------B--------B-B------Mo-----B----------B-----------B---------o-M---B-----------------BBB--B-o-------------B---o-----v
-------------B-------B---B-----Bo-------------B-Bo------o-------oo---------------?-o-----o---o----o------B-----------oo-B---------B------B--------B-----B-----------------oo-------oo--B---B------B----f
--------o--B-------B----------M-MB-------------?------------B-------B--B------------------B---------o-------o---------------------------------B-----B-------------o--Bo--B------------------o-------B--f
---------o---B--o------B-B----o-------B-------------B---B---B-B------------o---------o------------------------Bo------------o-----o-B-o--oo--------------?--------B-M-B--B-----B---------o-------------f
-----------o--o-M------B---?-B----------B--B--T-----o----B-?-?B----B--------M-BM----------o-o----------o-M-?--BB-------o-------------?-M-BB-------M---o------o--M-----?-----?--To--o-oM--?-------------f
----------------------B-------?----B--?-------|--o-BT-B-----B----T-----o-?-?B----o?---MM--Too----o------oo------T--oB-B-o-----------oo-------o----o-T----?--?-T--o--M-----o----|BB-B--------o----o----?f
-TB--B--T--------?-oT-----?M-o-?----?--oo-----|?T--T|M---?X--B---|----------------------B-|-----o-B?--TBo----T--|B---------B-----------T-??o--------|o---B----|oo--------BMB-M-|-------BT--------T-B--of
m|-B-E--|----B---o--|E-E-X-----Eo------E-----o|o|--||B---EX----BB|-X-B--B-X-X-X-------X---X---X-o-Bo--|------|--X-o---B-B--------------|-E------E-B-|---X-----|---B-X-BX---o---|X-------|--o----X|---B-X
XXXXXXXXXXXXXXXXXXXXXXXXXXXXXXXXXXXXXXXXXXXXXXXXXXXXXXXXXXXXXXXXXXXXXXXXXXXXXXXXXXXXXXXXXXXXXXXXXXXXXXXXXXXXXXXXXXXXXXXXXXXXXXXXXXXXXXXXXXXXXXXXXXXXXXXXXXXXXXXXXXXXXXXXXXXXXXXXXXXXXXXXXXXXXXXXXXXXXXXX
