-------B----B-------?B-----B---------B---B------------------?----------B---------E----?-----------------B-B---B------B--------------------------------BB---B-------E------B-----B---------------M----Bo|
B-B?---B-B--?----B--------?-o?B--------------------B----B---B---?B-------o-------B---B-----------------------?--E----------B-o--B-----------------------B-------?--B---------------------B-------------|
|-BBB--o---------------B--B----o?-B-----------o----BB-------------B--------B--B---------------------?--B-E----B-BM-----E-----------B-------------------B---------------------B--------------E----oB?-B-|
E----------------?-B----BE---------o-o--BE-------------------B-------------------------------------B-----B-BB--?--B---?B------------BE-------------B--?----E----------------?-----------MB--B--E--B--?-T
X------------------?--B--B----------?----B?------B----------------?---B--E------------------B---B--B-----B-----B---------------------BB--------------B--?--B-------B--?B------B-----------B----B-------X
X------BB-E---EE-----BB------?------------B------M---------------------B-B------B----------oE-B---?------B-------------------B---------o------------------------B?-E-------------o------B----?-BB-----EX
?--B--B---B---BB--o------------------B-------B-B----o---E---?----o-B-o-----------B----------BB--------B--E--------------------B---------B-----?----B---------------B---B-------B-------B------------BBBX
|----------BB----?----------BB--M-----------------------B---o-----------EB----------B----B-----BB?-------B-----------------------------------?-----B-----?--B---BB----------B--?---------------B--BB---v
X--------B-B-------B-?---o----------B----------------M--M-----?----o?---B--------B-----------B-----M----o----------------------------?--?-?---B-----------------------------B-------------------B------|
o-------------o----------B------o--------o------BB----------------?---------------------?--------B----------------B--B-------B----------oB---o-------------------o-----------BB----B-?----B----B-------|
B----B--?--?B-----------------M---------------B------B-----?-B------B---oB-------B------------?----------------------------T-------B-----B-B------?B---B---------B-o-----?-----------------------------X
-------B-------------E---------------------?----B------T----BB---?T-M----?----B-------B---T---------B----------?--------B-B|---B------E--------T-------?-------BB-----MB---B--B--------T---B-B---------T
XT-------T-B-BT------B----B-B-----------B---B-----B----|-T--------|----------B---B-B------|?------T-------?--BB--------?---|----------B--------|------------TB----------------------BB-|-----B-------B-T
||B------|B---|T-E----ET---TXT-B-T--T-BBB-----------T--X-|B-------|-B-T-------E-T-------T-|----BT-|---T---E-----B-----T--TBX------BB-----------|B--T--------|-----T-TT-T-T-B---B----E--|TT-TBE---------B
m|E----B-|----||-BB---X|E--|X|---|--|B--B--B---X-BB-|--X-|------E-|---|-----E-X-|--B---E|-|B---E|-X---|---B---E-X-----|E-|-XE---E--X--X-----B--X--B|E------BX-B---|-||-|-|-E--E--B-XB--|||B|BXB--------E
XXXXXXXXXXXXXXXXXXXXXXXXXXXXXXXXXXXXXXXXXXXXXXXXXXXXXXXXXXXXXXXXXXXXXXXXXXXXXXXXXXXXXXXXXXXXXXXXXXXXXXXXXXXXXXXXXXXXXXXXXXXXXXXXXXXXXXXXXXXXXXXXXXXXXXXXXXXXXXXXXXXXXXXXXXXXXXXXXXXXXXXXXXXXXXXXXXXXXXXX
