T------Bo--------B----?-------B----o--B----------------------B--B-B------------------BB-----?-------------?----------------B-B------B-?-----------------------------------B----------B------------B---B-
|-----------------B-?-E---------------------B----B--B-?--Bo--?-----B--?--BB------B-E----------------------E-----oE-----B----?-B-B-E---B-E-----B----B--B--o-B--B-B-B--------Bo----?--B---------------BBE|
X-------------BB-----?B--------M-------?------------------------------------B------B-----------?----------B------B---B--B---------B-----B------B-E-----------B-----------B----------------------------B-
X-----B-B--B-------------B----------B--oB-----------------B---------------B---------B-------?B-B------B---B---------------B-----?-------?BBo--B--B-----o-----------B---------o-----------------o------BX
|E-B-B-------B----B----o?-------------o-BBo------------------?--E---o-----------------B-----------?-----?----B--------B-----?--M-----------E-------------o----B----------------------------------------X
XB--B-B-----B------B--------E---------BB------------------------B------B------B-B-----B-----------------------------------B------B----?--E-B-------------?---B-----E-B--------?---------B-------------?|
B-------o--B------oB--------B---------B---?------------Bo-----------E-o-?----------------------------------------B--?--------------------B--o-------o---------B----B-----B--B-------------B-------B----T
B----------B--------------------B-----------------B-----------M-----B-?---------------B-?--B------?-------------------------B----B------------B--------------------------B---------------------E-?-----v
-B----------B----------?----B-------B---?-----------BB--------------B---------------E----?----?------B---B----?--B-B--------oB-------B-EB---MB-----E--E--------?--o-------B--------oE----------B-------X
X-----B---------------BB----BB-------B----M----BBB--------B-B---------o-----B--BB---B------------o---------------------B-------?-------B-?---------B--B---------?B-----------?------B-E-----------E--T-?
X--B-B---------------------B-BB-B-------------------B-B---?-----o--------------B------------M-----E---------B------BM------B-----------------o----------?--BB-----------B-------?-----B--------E--B--|-E
|---------o-----------------T-B--------------o--B-------X----B--------------B---------B------M----B-------------B--------B?---------------------B-----------------B----o------B----------------B---BB|-X
X---------X-----B-------B---|-------B----B-----T--B---T-Xo-B-----B---T---BXEB-----B---T-B---o----BBTT-------T--T-T-------------T-----o-B---?-B---B?-B--B----------T-T-T-----------?------T-B-B----TXBX-T
X-BT---B--X---o---TTTB------|-------B-TT-------|T-T--o|-X----BE---B--|ET-BXB-------T--|-X-----o-B--||-T-----|-B|T|ET-B--------E|--T----------T---B---T-----T---T-T|-|B|-B-B-T---XT-B-----|-X--BB--|XTX-|
mXE|EE-EBEXB--E---|||---E-E-|-E------E||---E-B-||-|--BXBX-----B-----oXB|--X-----o--|--|-X--BX-oEX-EX|o|E-B-oX--|||B|-XXE-E-B--B|--|-E----E-Bo|--E--E-|--E--|B-E|-||E|BX-BEB-|---X|-BBBBB-|-X-EBB-EXX|X-|
XXXXXXXXXXXXXXXXXXXXXXXXXXXXXXXXXXXXXXXXXXXXXXXXXXXXXXXXXXXXXXXXXXXXXXXXXXXXXXXXXXXXXXXXXXXXXXXXXXXXXXXXXXXXXXXXXXXXXXXXXXXXXXXXXXXXXXXXXXXXXXXXXXXXXXXXXXXXXXXXXXXXXXXXXXXXXXXXXXXXXXXXXXXXXXXXXXXXXXXX
