EX----E----B----B-----BB-B--B-?-----------?------------?----B?--------B-----B---B-----?---------------------B---B--?-----------------------------B--------------E----------------B---------------B-----T
EE----B--------------------B-o----------------oo--------------B--------BB-------------B----------?---------------B----------------------E-----E-B--?-------?----B---B----------?E-----E------------B---X
XX-EB-------------?--------------------?---o-----B?------------------------------?------------B--B--B-------------------------------B---B-----B----------------B------B-o-------B-----B---------M------X
|X-B----------------------B------------------------BB-------------B------E--?----B----?-----o-B---------B--?----------B--B-B----B-BB-----?--B-----------------------BEB----B------------E--------------X
XX-----------B--------------B----------B-------------------------o----BB-B-----------------------------?-B-B-----B--------o-----------?----------M---------B---------B?-----------------Bo-----------B-X
|X----B-------B----------?------?-----------B-B------------------oB-B---------o----------------------B-----------B--------------------E--B-------------?--B--B--B---------?-------B-------B---o--------E
BX--B----B------------B-B--------------------B---B---------------?----------B--------?----o---------BB-B--?-------o---?-B---------B---B--B-?-o---B---B--B-B----?-B-----------B-B------B---------B------X
XE-----B----o----B---------?---E--B-------?------------------------------E----------------------o------------B-Bo----M--------?------B------------E-----E----------------------------B-----------------v
|X-----------------B--B-------?B-----------------E--------BB-------------B-----?-----B-B-BB------------B------?---MM----B-B--------------B---B----BB----B---B---------?B------B---B-o---B-----------M--E
XX----B---B-----B---B-----------?B---B-----------B-B--------------------o--?--------?--o----------------------B----BB--M----B---------B--B-B--?---Bo-------------B----B---B---B--------M------------oB-E
|B---------------------B-M------------------------------------B-----?B-----------B---?--B---------?------E------------?--------B-?-----M-------------------------B-B----B--?----------------o-T--------|
X---------E------------T---?--B-----BT----------B--------?------------B------o--BBT--------------Bo-----BBo---X----TB---B--o---?--B----------?-----B?-------------T----B---E-------B----------|-----M--|
XT-T-T----B---B-T------|T------B----?|------------------------------------M---BB-E|?--TT--------T----o--------X---E|-T-T------T-------T---BT--?--------B-E-----TT-|--------B-B----?----T------|--B--B--X
EE-|-|E---B-X-B-|-----TX|-----BEE---o|B-T-T--B---B-o----TBE----------B--------TB-B|---||--E-E--B|----------T-TX-TTX|-|-|E--o--|TT-----|-B--|-BT----T--B-TB-T---||T|-TB-TT-TT-------T---|------|-B------|
mXX|-XX--XE-X--o|--BB-|XX-----BXB-o--|--|B|---B-----EE--|-X----B-------B-B-BE-|-EBX---|XE-XEXE-XXo-EBo-E-X-|-|X-||X|-|B|B---EE|||---XX|BX-X|E-|E---|--X-|B-|B--||||-|--||-||-B----E|o-E|--EE--XE---E--BX
XoXXXXXXXXXXXXXXXXXXXXXXXXXXXXXXXXXXXXXXXXXXXXXXXXXXXXXXXXXXXXXXXXXXXXXXXXXXXXXXXXXXXXXXXXXXXXXXXXXXXXXXXXXXXXXXXXXXXXXXXXXXXXXXXXXXXXXXXXXXXXXXXXXXXXXXXXXXXXXXXXXXXXXXXXXXXXXXXXXXXXXXXXXXXXXXXXXXXXXX
