X---------------oB------?-----------?-B------B-----B-E---EB-------B--------B----B-------------------B-B----B-------------B-----------------B--BM--B---------------B------------B-------B--------?------X
|----------------------------------------------------BB--B-------o--E----------?---B---B-----------------------------E----o-----------------------------BB---------------------------BBBB?-B------o----T
T--o--------B-----------B-------------------BB----------------------B-B----B-----B----o----o----Bo------------B------B----------------B----o-----B--B-M---BB----------------------B---B---o?--------B-B?
|----B----------E----------------?----B-M-------B--------------BB---------------B-----------B-----E--------o?-----?------B-?-------------------B--------B--M?-------o----?--------?-----?--------------X
B-----?----B----B-----o---BBB---B---?--------EB--?----------E---B--------?-----?o----------B------B--------------B------------B-?---B--BB----------------------B---M---------B----B-B-----B------B----B|
----------------------------B----B-----------B--B-B------?--B--?-E-----------------------------BB-----?-B----------B----------E--?--BB-?--E-M-------?o-----B------------?----E----------B-----B------B--
X-------o----------------------------B-B-------------------------B------BB---o-B---------B--?-----B-BB------?---------M-----?-B-----------BE---------B-----B--------o--------B------?--B--B------------E
-------------B-----B----BoB--------B-------------B----B-B-------------------B--B---BB--------oB----------M----------o---------B--E------B--B--------o-------------------B----------------------MB-E----v
X?---------B----M----------------o-------B----B------------------B-------??--B----------------------------B-----o----------------B-----?-----B-B----?-----E---B----o---------B------------------BBB-----
T----------B------------B--------B--B----------B---B-----B-------------------------B------B------B-----B-----------------------B-------------B?---B-B-----B------------B--B--B--oB---B---------B-----B-X
-----------------------?--------------------B----B?-----B-BB--------------------B-B??--E-----B---------B-----------------------------?--B-B----?-o------B--B-B--B-?--------?------------T--------------X
T-----B------T---------o-------BB---o-----------B--T---------------------MB---T----B---X?--------BE--------o------M---?B-T----B-B-------------B---EB---------B-------M--o-M----B-B-----B|---------B-T--?
X---B-T------|-----E-B-T-----oB-o--B--T---B---E--?-|--------T----------BTBB---|--------X----------B--------TB---------B-X|---BT--------T-------B--X--B-E-BX----o-X---oB------B-----oT---|-------?---|--B
T-----|--B---X-B---XTT-|E-TB-TE----B--|----BTBX----|X-TE--TB|----T-EB-B-|-B-T-|------T-X----E------BT-B-B--|----------E-X|----|-B----T-|-------X--X--T-X--X-----TX--B---E-T-TT----o-|---|-T-T---T---|--|
mX--B-X--XBX-X---E-X||-XXE|--|XXE-----|---X-|-X-B-E|X-|XE-|-X--BB|-B----X---|-X--X--E|-X-B--X-------|---X-EXE---E-E---B-X|-BEE|------|EX--B----X-EXB-|-XXXX--o--|X------B-|-||-----E|---XE|-|---|---|BET
XXXXXXXXXXXXXXXXXXXXXXXXXXXXXXXXXXXXXXXXXXXXXXXXXXXXXXXXXXXXXXXXXXXXXXXXXXXXXXXXXXXXXXXXXXXXXXXXXXXXXXXXXXXXXXXXXXXXXXXXXXXXXXXXXXXXXXXXXXXXXXXXXXXXXXXXXXXXXXXXXXXXXXXXXXXXXXXXXXXXXXXXXXXXXXXXXXXXXXXX
