X---o--B---------B-----?------B------B----------B---?-------B----------------------B---------B-B----------------B----B-B-----oE?--?-B--BB---B-------------------B-------B-----------B--B---B-B---B-----E
E------B-------------------B-------------E--B-o---------------B---B-----B--------------------B------------------------------B-B------B--B----?-B--B-----oBB--------------o----------B-------o----------|
X------------?--?----?-B--------?---B----B--B---------------B----B-------------------B-----B----?----------B-B-?--------------B------------------B-B------------B-------------B-----------------B------B
|B----------------B---------E--------------B-----o-------E-B------B--M-----B---------------------------B------------B-----------B-B------------------B----------B----------B----oB------------------B--X
----E---B-----------?B---?BBB---------B---------------B--B---B----------------B----B-B----B------------------------------------------B-----------B--B---------B-o------?--------?------B---B-------o---|
B---B---B--B------------B-B--BM---------E-----B--------------B-------B-----B--?--------B---o--BB----B-E-----------------?--------M---------B---------?------?--B------E--------B------------B---------BT
B----BB-------B----B------?---BE---B----B-----o--B--B----o-------------------------------B--E---------B--B---B-------------?----B-o--?---Eo-----------B----------BB---B---------B------B-B-----------B-E
|------------------------B-----B---------B-?-----B---M----B--M--------B----------B-----B----B---------BE-B--------------B--B----------B--B--o---------B-o------B------B------B-------B------o--B----o--v
|------o------B-o------------o---B--B----B------------B-----------B---------------B-------------------?B-B--B-B----B-o-------B---?------?-?B--------------B----------------------?--------------BB---B-X
X--B-------------B-----------------B------B---BB----------?----B---------B------?---EB---B---------B---?--o-oo---------------B--------E------------------B-------M------B----------B-------------------X
T-B--------------------------B---o---B?-B----------BB--------------B--T-BT----------B-----B----B-------------------B------------------BB-----B--------B-B----B-------------o-----------B---------------|
-?--------B-BB--B----B------------------------B-----------------------|--|-------B-------------B----?o--------------B---E-B-------------------B------B------B----BB-----BB?--?o---------B?-------------X
E---E-----T----------------?------B-----B-o---T-----------------------|--|---B---E---?---------T------BBo-----------oE--BT---------------------------B--TB---------?---------------------T--?----------X
X---X-X-X-|-T-TBTE----B----BB----B---B-----X--|-----TT--------BT--B---|--X----TTXBBBTBTT-----T-|----------T----TE----XB--|-oT--T---T--B-T----T---T----B-|----ET--B----T-----TB-X-B-------|--T---B---E--X
m-B-XXXBX-|E|B|E|XX---X-----E-Bo--B--E-----XE-X--B-E||B--EX---X|EE---E|E-X--E-||X---|-||o----|-|B----E--E-|Bo--|X----X-B-X--|E-|-BX|----|----|BX-|---B--|----X|-E---E-|-o--B|--X--E---XB-X--|E---XB-X--E
XXXXXXXXXXXXXXXXXXXXXXXXXXXXXXXXXXXXXXXXXXXXXXXXXXXXXXXXXXXXXXXXXXXXXXXXXXXXXXXXXXXXXXXXXXXXXXXXXXXXXXXXXXXXXXXXXXXXXXXXXXXXXXXXXXXXXXXXXXXXXXXXXXXXXXXXXXXXXXXXXXXXXXXXXXXXXXXXXXXXXXXXXXXXXXXXXXXXXXXX
