B-B----B?-----------------------BB---o-B--------B-B----B--B-B------------------B--B-o--------B----B-----B------B------B----------------------------B-----o---------B---BM----B------?---B-B-?-------B--o
X-------------BB?-------B--------?------------B-----M--B-?-B-------------------------B------B?B------------B-B---E--------------------o--------B--B--B-B----------------B------------B------B----o-----X
X----B-----------------------------?---------B---------?-------B-------------------B-------o---------------------B---BB?---?-------------------B--------------?-----------------?--------o--B-o------?-|
X---B------E--------?----B---------------------B--------B-B-----E--------------BBB--------------------M------?-----------------o--BB-----------Eo----------------------------M-?----------B------B--?---
X-----B---BB------------------B---------------------------------B------------B-?-------B?-----------------?-o--------B-------------------------B--?-----------------------EB---------------------B-B---?
X-----B------------M--------B--------------------B-----------------B---------------------B---------?----?--?-------------------B-----?--------------------------B---------B---------B------------------X
-o----------------------------?--------------B--B--------------?------BB--B------BB------B----------B------B?B-----------B----M------B-------------------------------o--B------------M---?----------?-BE
|B-----E--o----------------------B----B------------BB------B-B--B----o-----M--B--B---B--?--?-------------B----B--------B------B-------B-----B-----------?----B---?----o-B----B------B-------E----------v
X--BB--B-E-----------o----B----------o----M----------B----B-?----B-------M---------B-----?------------BB---E---------?------------------------?-----------------------B--o--------------o---B-----o---BE
----?--B-B-------?-o---EB---------------B-B--------------------------------B------?----BB----B---B----E---?B----E------------o------B-------------------------------?--------------?B---B------------B?|
M---------------------BB-----------B--------B-T---------------------?-------?------B----------B-TB--BTB---------B-------B---------------?--------B---------B--------------------------B?---?-?-B------BX
|---o---------M-B----------------------M------|--?----B---E-------------B-oB---B----B---B-------|----|-E-----T----------------B--B--o----B?----B--B-T-T-B--------?----?----B----B--------------T-------?
X--------------B--E--B-------B------B-?-B-B---X-o-------TBB-B----T------------B---T--B-----o-BB-|----X-B----T|o----B----------o--T------B--BB----T--|-|--X-------BT-M---M----------T-----------|-------B
X--------T-X------B-T---T----T-----T--B-------X--T------|---T---B|--X-T--T----B--E|---B--T---T--|----X------||------B--TT---XX--T|T-TTB--BBTE--B-|oB|-|--X-B-BT---|----T--------TBT|-----------X-------E
m---B--B-|-XB----EX-|-X-|-BE-|-----|----E-E--oX--|E-E--E|X--|-B--X-EXB|EE|-------BX-B---E|---|--XEEB-X------||----E----||-B-XXBB|X|E||E---X|X-B-EX-BX-|-XX----|---|---E|E---E-BB|X|X--E-X---E--X----B--E
XXXXXXXXXXXXXXXXXXXXXXXXXXXXXXXXXXXXXXXXXXXXXXXXXXXXXXXXXXXXXXXXXXXXXXXXXXXXXXXXXXXXXXXXXXXXXXXXXXXXXXXXXXXXXXXXXXXXXXXXXXXXXXXXXXXXXXXXXXXXXXXXXXXXXXXXXXXXXXXXXXXXXXXXXXXXXXXXXXXXXXXXXXXXXXXXXXXXXXXX
