T----------------------B----oo---------BB----------------------------------------------B-------------o----------------------Bo-----o--------o-----o--o---B-----B-o----o--BB-------------------------o--X
-?------------o--B-------B-----B----B-B-B-B--B-------------------------B---B-B-B-B------------B----B----------B----B-----o--------------B-------------------B--------o--o------B---------B-------------E
-----------o----Boo-----------------B-----o------------------B-------------o------o-----------------B------o-B--------o---------------------o--B--B--o-------------------------------B----------B------o
-------------B------------------o--------------------o-B---------B---o---------------------------o-----B-----B---B--B--------B---------o------B--------B----------------M---------------------------B--M
?--o----o-o---B--------------BB--------------o--o-----B---o------B------------B------o------------------oo-----B---------B------------o------B----------------B-----B---B-------o-----------o----------|
M-----------------o-----BB--------o---------------------------------o--------B-------o---------------------------o--------o-----B------B-----oB-----o---------B-------------------------B-o------B-----B
---------------------B--o-----------------------------------B-------o---o-----------------------------------o-B-------------B--B-----o--oo---B--------B-------o------------B---o-----------------------E
|-------oBB?--------B-------------o----oB---------oB--------------B----B-M------------------------B-------------M------B---------------?o----------o--o------o-----------?-?------------------------o--v
-----o-------------B----------------------M?------------------------------Bo-o-----------B----o-------B---o-----oB---BB-----------------------B--o-B----------B------B--o----------------B--B--o------o-
|---o---?B-o----------------------------------o---------?M--o---------------B------B--------------T-------B-----B-----------------B----B-B------B-o--------------------ooo---------------------o---o---|
|o----------o-B----------B-o---------T---o-Bo------B--B------------------B-B---B--------B--oo-B---|-------M-------o--------------B--o---------B---------------------------B---o----B-------------------|
B--o-B--o--TM-B--oo--?-----------B---|-----------------M-B----?-?---B----?B------B-T-----o--------|----o----?--M--------------MMB--B?-M---B----o-----B---------BB----o----M--??-B--------o-----o-------M
X----------|-o--BBMBT-----B-------M--|--B??--T-----M-----------B------T------------|-o------?--?--|---------------------------------o------B---M-o--?----?------B-o-o----M-----M-----------BTM?-B------B
M------o?--|--------|-T---B-?--B-Bo--|-------|---B----B-?-?o-----T--?-|--oo-M-----B|B-o--Mo-------|BM--T-M-----o-o--TB---M-------B----B---T--B------B--T-Bo-B------o------B-T-?--?----------|----------|
m----E-----|-X-----B|-|----E-ooE-----|X----X-|-X--B----o-------o-|-o--|-X-B-E---EX-Xo---o-oXXXE---|--B-|o--X--------|X-E-----E-----B---o--|--XX-X---E--|--B-o--B-----X-----B|X----EB--o--E--|----EE--B-|
XXXXXXXXXXXXXXXXXXXXXXXXXXXXXXXXXXXXXXXXXXXXXXXXXXXXXXXXXXXXXXXXXXXXXXXXXXXXXXXXXXXXXXXXXXXXXXXXXXXXXXXXXXXXXXXXXXXXXXXXXXXXXXXXXXXXXXXXXXXXXXXXXXXXXXXXXXXXXXXXXXXXXXXXXXXXXXXXXXXXXXXXXXXXXXXXXXXXXXXX
