E-B-B-----B-o--B---B-------?-------------B---------------------B---------?-----B--B----?-B----B---------------B-?-------BB----B------------B------------B--BBB-----BBE--------B?-B-------B------?----B-|
?----------------------------B-----B----?------?-----------------B-----B-----B----B--BB---B-----------o-------E-------B-----------------B--BBB-----------M---B------EB--E-----E---o-----------?-B------|
|-------------BB---------B-------------B-o---BB--E--?--B------------?---B-----------M----BM-------------------B-B-B--M------o---B?--B-------o----------E-----B-BB---B---B--B--B--------?---B--o--------X
TE--?-----BB---B----B------BB---------E--B------BB----?---------o-B----B--------M----B-----?-o--------B--------B--------B-------------------B--E------BB------?-B---B--------B----?B--------MB---------B
EB-----?--B-B-----BEB-------------B--?B?---------B--------o--B?------BB-----------------------B?--?---B----B----------?---------B----B-o------BB-------M----------B----------------B------------------MX
---------B----B?EB-BE---?-----oo-------------------o-------------B----E----------?-----------B-------------?-----B--------------------------------B-B---------B---------------------B---------------B--X
-B---?E---------B--BB-?---?B--?--B----B--?------BB-------------B------B-----------------------------?--B---------B-------E-------------------------Bo-----?----M---------BB---------?-E------------B--BX
X-----B-----------------------B----B---B------------------------BB---------?B---------------B?----------?--o-E-----B-----B--E--E-B-B------B----------B-B------------------------------B----?-B---------v
|-----------B----------?---------------B-----B---------------------------?BB-----B------M----------?-----?---B--B----------?B--B--?--oB--o----B-------B--B--------B-BB-------------B-----BB------------X
|M?M------------?---B------B----X--------?--BB?----B-B-------B------------?----------------B----B----B-B---?-B--------B--------B-----------B--------?-------------E-M-----B----B--------B?---T---------|
E-o--E------?E---B---------o-B?-XBBB-----BB------B----------B--B-------E-----B--B-----------------B--B-----B----------------B?-?-------o------------B-----B-----B-B-E--------Bo----B-?-------|----------
X-B-BB------BX--T-------M----B-BX--T-------BT--B----B----BB-o--------M-B-----T-----------------B----?---?-B---B-------B---B------T?-----B-------------X------BB-T---B------B-o-B-------------|--B-B-B--B
----T--------XBB|---T--?-----?--X--|----BB-T|-B-T-----T-------------T----B---|T-T-T-?----oBB--------T---------T---X----?-T?T--T--|----T---BT----------X---E-X---|-----------B----BT-----B----|------?--|
T---|--TTB-X-X--|---|--T--B---BTX-XXT----BB|XB-B|--T-T|B---TBB-----T|----T--EX|-|-|XT-------B-----T-|----E--TT|-T-X-T-T--|B|BT|T-|-T--|X-T-|TT-T----B-X-T-BTX---X--TT--E--B--TT-T-|-----TX---|-T------TB
m-E-|B-||-BXXXE-|--XX-X|B------|X-XX|-B-XE-XX---|--|-||BE--|-X-----||---E|-XBXX-X-XX|-------------|-|--E-B--|||-|BX-|B|--XBXB|X|-XX|--XX-|-|||B|BB----XE|-X|X---X--||--B----B||-|-X-----|X---X-|--X-EE|E
XXXXXXXXXXXXXXXXXXXXXXXXXXXXXXXXXXXXXXXXXXXXXXXXXXXXXXXXXXXXXXXXXXXXXXXXXXXXXXXXXXXXXXXXXXXXXXXXXXXXXXXXXXXXXXXXXXXXXXXXXXXXXXXXXXXXXXXXXXXXXXXXXXXXXXXXXXXXXXXXXXXXXXXXXXXXXXXXXXXXXXXXXXXXXXXXXXXXXXXX
