---------------------------------------------------------------------o----------------------------------------------------------------------------------------------------X-----------------------------
-----------------------------------------------XXXXX------------------X----------------------B------------------------------------------------------------------------------------------?????-----------
-------------------------------------------------------------------------------B----------------------------------------B----------------B--------------------------------------------------------------
-------------------------------------------------------------------------------------o----------T---------------------o---------------------------------------------------------------------------------
--------------------------------------------------X----------------------------------------X----|-----------------------T--------------------------------------???------------------------------B-------
-----------------------------------------------------------------------------M------------------|-----------------------|-------------------------------------------------------------------------------
------?------X-------------XX-------------------------------------o------------X--------B---T---|-----------------------|-------------------------------------B----?--------------T---------------------
------------XX-------------XXX----------------X--------------------------------------------o|---|-----------XXX---------|---------------------------------------------------------|--------------------v
-----------XXX-------------XXXX-----o--------XX---------------------------------------------|---|-----------------------|--------o------------------------------------------------|--------------------f
----------XXXX-------------XXXXX------------XXX-------------------------------------T----X--|---|----XXXXX--------------|---------------------------------------------------------|--------B-----------f
---------XXXXX-----X-------XXXXXX----------XXXX-------------------------???-----X---|----XX-|---|-----------------------|--------------------------------------------------X------|--------------------f
--------XXXXXX-------------XXXXXXX--------XXXXX---------------------------------XX--|???-XXX|---|-----------------------|-T------X------------X--X-------------------------XX-----|------o-----------B-f
-----M-XXXXXXX-------------XXXXXXXX------XXXXXX-------------------------X-------XXX-|--??XXX|---|-----------------T-----|-|------------------XX--XX--------------------T---XXX----|------X-----------X-f
------XXXXXXXX-------------XXXXXXXXX--??XXXXXXX---------??????---------XXXX-----XXXX|M---XXX|X--|-o-----M---------|-----|-|------X----------XXX--XXX-------------------|---XXXX---|---------o-------XX-f
m----XXXXXXXXXX----------E-XXXXXXXXXX--XXXXXXXX------------E----------XXX------EXXXX|----XXX|XX-|o------------E-E-|-----|-|--EE-XX--E------XXXXE-XXXX-------------E--E-|---XXXXXE-|--X-----E-------XXX-X
XXXXXXXXXXXXXXXXXXXXXXXXX--XXXXXXXXXXXXXXXXXXXX-----XXXXXXXXXXXX-----XXXX-------XXXX|XX--XXX|XXX|--------------XXX|XXXXX|X|X---XXX-XXXXXXXXXXXXXXXXXXXXXXXXXXXXXXXX----|---XXXXXXX|XXX-----XX-----XXXXXX
