T--------------B------B---B-B-B--B---B---E--------------------?----------------------B--------M--------oB-------B----------------B----------------o--------------B---B--------B-------?------B----------
|B--------------o-------------B----------B------B--------------------------------------B----------B-----B----BB-B-B-------------E----?-------B-BB---------B----------B-B----B-B-------B----------------X
---B------o---B----B--?--o--------B-------?--------------B----------------------E---o-?-----M---B---B----E----------------------B-------------B----?-------B--?-?-B-------B------B-B--------o-B---------
-----------------------?-B---------o-B---E-B------------------------------------B-----B--B---BoB------B?-B-oB----------?------------E---------E-------------oo--B-----BB-B--------B-------------------oT
X------------------------------o--B?--B--B--------BB--------B----B----B------B----?-------B---BB--B-o---B-----------------B---------B-------BMB-B--------------E------------B----------------B---------|
|-----?--------------------------------------B--------------B----B--------------------------------B-----------------?----B----B------B-------------------------BB--------B-o-B-B--------B--------------X
XB---BB------B----------------------------B-?-----B------M-B----o--B----------B------------------------B--B------------B---B--------------BB-------B-----o-----B-----------B-------------------B------o|
|-------B-B----B-----------B--------------B------------------B-----------------------------------------------------------B-------B-?--------------?-------B----------B--?-----------------?--B-B--M--B-v
X--?---B--------B-B---------------M----B-B--B----B------------B-B-B---B------B-------------B---------?-------B-----------B-------------B--B---o-----B?B------------B------B-------------------?B?---o--E
|-?-B---B---B?---------------B---------BB---?---B-----B----?-------------------------B-B------------M----B-----------B-----------B----B---?----BB-----B--B-------o--------?--o-B-o---B----------------MB
|--------------------B----E-----B---BB---?-------B----B--B---------------------B------XTB?-M--X-B-BB----------M------------B-----------------B-B------------------------BB------B----------B-----------X
---------------------?----B--?-----?----E-------------TB---------------B--------B-o---X|B-----X---E----B--T----B--------B------M-----------T-------T--------T-B-------TE-?--T--------Bo?--B-----BB-----|
X------?--B---T-----------?-B-?---------B---B---------|-E------?---------B--BE--B-----XX------X---B-------|-B--T---B--B------------B----B-B|-TT-T--|--------|---?-----|B----|--TB-----?-B---B----------X
|T--T-T--B----|B-T---B------B---BT--------T--X---T--T-|-B--TT-T-T-T------T--TB-BXT-oTTXXT-B-T-X--BT--X-TT-X-X-T|----B-TT--------------B---T|-||-|-TX--BTB---XT-T--TT--|---B-X--|-T-T----TE------BE-E-T-T
m|-X|-|-oX----XE-|---XEEX---B---B|EX--EB--|E-X---|-B|B|E---||-|-|-|-E-X-B|X-|-X-X|--||XX|B-E|-X---|-EX-||-X-X-|X------||--B-XE----XEBXB--E||-XX-|-|XX--|----X|B|-o||-B|----XX-BX-|-|----|X---B---XEB-|-X
XXXXXXXXXXXXXXXXXXXXXXXXXXXXXXXXXXXXXXXXXXXXXXXXXXXXXXXXXXXXXXXXXXXXXXXXXXXXXXXXXXXXXXXXXXXXXXXXXXXXXXXXXXXXXXXXXXXXXXXXXXXXXXXXXXXXXXXXXXXXXXXXXXXXXXXXXXXXXXXXXXXXXXXXXXXXXXXXXXXXXXXXXXXXXXXXXXXXXXXX
