--o----o------------------o---------B-----------------------------------B------o---------------------------B--o----o-----------o--B----o-o----o--------Bo------B----------o--------------o-B--B---B-----
--------------o-------B------B----o---------------------------B-------B----o------B--------o----BB---------B---------------oB---------o----------------------------o--------B-----BB---------------o----
---o-----------o-------o-----o------o-------------o---o--------------B------o-------------------Bo-----B---B----------------Bo------------B-o----------B-------o-------o---B----o---------------------B-
----o---B-------B----------oB--o------o---------------B-------------B----------o----B----o-B---B----o--------B-----o---------------------Bo---------B-------o--------o-o-----B---o-B---B------------B---
----------B---o------o------------------o--B-----B-------B-----oo------o------------oo---------------B-----BB--o----o----------------------B----o--o--B-----B----------------B-----------o--B-B---------
----B------------------------o---B-B--B---------B-----B--------------o--------------B----o------------o--------o-------oo------------------------o-----M------o---------B---o----------------B-B--------
----------------o---B---------------o---o------------------B-----o-----------oB-o---B---------o---------------o---------B----o---------------o---------------------o---B------B---o---o------------B----
-o---------o-B--B---B---oB-B---------------------B--B---------------------o--o----------B--------Bo-M----o------------------------B------B------o---------------o----M-------BBo----------o-B------oBo-v
-------------B-o--------------------------------Bo---------------o----o------------B--------------o---B-------------------o---------oo---B--------------B------------------o--------o------------------f
--T---B------o-----B-M-B-------o---o-------o-------------------------B-B---B---------oB---B-B---------------o-------B--------o--------B-------------T--?-------B---------B-----------------------------f
--|---o------oo-o---o------------------------o--------------B--------T--o-------o---Bo--------------B------o------------------------B----o----oo--o-|-----------------BB---B---------------------B-----f
-T|-------ToB-o--?--T--o-?-B-B---------------------------B-B-?T------|B?-oB---B-?-----oB---------o---M-oB-----B--------o?---------------------------|B-------M---M---B?-------B--B---oM?-------?-------f
-||---M---|---------|---------?--B------oT-----o---T-----?--?-|M?---B|-o---BB-M--o-----M--M---?----------o----------o-B-----B--------M--?----o-----?|----B------B--B--o---o------T-B-----B----Mo-------f
-||--B----|---?T-?--|-?-M---To------o---B|---------|----B-M---|------|---------M--??----BM-o--o---B?-----?----B---B--T------------BTo----?-o--------|BM---------o----M----MBB--T-|---?---------B-------f
m||--XBE--|XB-B|-EB-|--E---E|-----------B|---o-E---|-B---E---o|-E--X-X---BX---Xo------X-X-X-E--o----X-o--E--------o--|---------E--B|---X---B--E-E---|-o----B-XB---B-X-X----B---|E|-BB---------B-X----E-X
XXXXXXXXXXXXXXXXXXXXXXXXXXXXXXXXXXXXXXXXXXXXXXXXXXXXXXXXXXXXXXXXXXXXXXXXXXXXXXXXXXXXXXXXXXXXXXXXXXXXXXXXXXXXXXXXXXXXXXXXXXXXXXXXXXXXXXXXXXXXXXXXXXXXXXXXXXXXXXXXXXXXXXXXXXXXXXXXXXXXXXXXXXXXXXXXXXXXXXXX
