|--------B-------o---B-----Boo-----o----oB-----o---o-o---------------B--------B--B----o-o-B----------------B--------------------------------o-------B---------oB-B--B-o--B----B--------------o----o-----
E---B-o----o-o----BB---B--------o-------B-B-o-o--------------o------o--oo--o----B-----------o------------------B------------------------B--B-------B--o--B------------------B---B-------B--------------o
T------Bo------o-------o---o---o------o--o-------------o--------o------------B---o------o-------B------------------------------------B---------B---BBo-------------o--B--B-----------------------------E
X-----------------BB---------------o-----------o-------------B---B-------------o-----------B---o-o---------------B--------------o-----------------B----B-B----oo----B------------o----B-------o-o-------
T---------------------B-B-----------------------------o---------B--------------------------B------o-B--B-o-----Bo-----B------o------------B---------o---------B--B-B-------------B----o---B------------T
B----------------------------------o----o-BB----o-----o-B-----------------B--------B------B-----o-----o--------------------B----B------B--------------B---------------T--------o---B----B-o-----oB-----?
o---------------------B-o-------------B-----B-B-----B---------------------B-B-----B-o---------------------------------B-----B------------B-----B---------------B----B-|o------o-----------B------------?
X--------o-B----------------------ooB----------------B------------------o----------------B-----o--o------------o-o--o---------o------------BB------o-------o-o---B-B-B|--BB------------B----o-B-------ov
B-----o---o-------------BB--------B----B------o-----o-------------------o--------------B------------------------------------o-------M-----------------------B-B-------|o--------------?--o---------o--B?
|?B------B----o---o------------------?--M----------B---B-Mo-o---B-o-------------B------B-M----------------B----------------------------?B-T----o?---------------------|oo------B--------ooo---B--------E
|---------o---------o--------------------------M------B--B---------------------B-B---------o---B---B---B-----------B-----------To---------|------------------------o--|------B--B-o-o----------o-B-----B
M---------?----B----B------B?B---BB----------B--?--------B---?-------o------------------o-M--o--o--o---B--B-o----------T-------|--M------o|---------?--?-?----o-------|------T----------o--o----------MB
|--------------------T-?--------Bo----------oTT----------------B-T----B?BT-----M----BT-MB---o-------B-------o---o------|?-o----|---M-----T|B-------------------?--?-B-|-TM-o-|M-------?------MB-?T--o--T
X-o?T---?-------M-???|o-T--o-X-B------?-M----||------M----?o---o-|o-?-T--|-----B-----|--M---------oB?----o-B-Bo------T-|-M?---T|--M-B---?||--o-oM-----o-----B----B----|-|B?--|---B--?-----M------|oT---?
m---|E--oB-----B-----|-o|o-E-X----BB-o---B---||X--------------EoXX---B|--|---o---o---|--o-----E----B-B-----Xo--B---E-|-X--o-B-||------EE-X|---------E-B-X---X---------|-|o---|B--oE--------E-E--X|-|-B-X
XXXXXXXXXXXXXXXXXXXXXXXXXXXXXXXXXXXXXXXXXXXXXXXXXXXXXXXXXXXXXXXXXXXXXXXXXXXXXXXXXXXXXXXXXXXXXXXXXXXXXXXXXXXXXXXXXXXXXXXXXXXXXXXXXXXXXXXXXXXXXXXXXXXXXXXXXXXXXXXXXXXXXXXXXXXXXXXXXXXXXXXXXXXXXXXXXXXXXXXX
