--------------------------------------------------------------------------------------------------------------------------------------------------------------------------------------------------------
--------------------------------------------------------------------------------------------------------------------------------------------------------------------------------------------------------
-------------------------------------X-----------------------------------------------------------------------o------------------------------------------------------------------------------------------
-------------------------------------------------------------------------------T-------------------------------------B-------------B--------M--T--------------------------T?----------------------------
---T-------------------------------------------T--X----------?-----------------|-----------T---------------------------------------o-X---------|--------------------------|---------------------BX----T-
---|------------T?-----------------------------|-------------------------------|-----------|---------------------------------------------------|--------------------------|----------------o----------|-
---|------------|------------------------------|--o-----------------???????----|--------B--|---------------------------------------------------|--------------B-----------|------o-------------------T|-
---|------------|------------------X-----T-o---|----------------TX--o----------|-----------|--------M---------------X-------------------???????|-------M-----------T------|--------------------------||v
---|------------|--------T---------------|-----|------------o---|----X---------|-----------|------------------------XX-------------------------|-------------------|------|--------------------------||f
---|------------|--------|----------T----|---?-|----------------|---XX---------|-----------|------------------------XXX------------------------|-------------------|------|--------X-----------------||f
---|------------|--------|----------|----|-----|----------------|--XXX---------|-----------|------------------------XXXX-M---------------------|XXXXXX-------------|------|X------------------------X||f
---|------------|--------|??--------|----|-----|----------------|-XXXX---------|-----------|------------------------XXXXX----T---X-------T-----|-------------------|------|XX-------------T--------XX||f
---|----------B?|--------|----------|----|-----|---------M------|XXXXX--X------|-------????|----------------------T-XXXXXX---|-----------|-----|-------------------|o-----|XXX???????-----|-------XXX||f
---|---------o--|--------|----------|----|-----|----------------|XXXXX-XX------|-----------|---------------------X|-XXXXXXX--|----------X|-----|-------------------|------|XXXX-----------|------XXXX||f
m--|----------o-|---E----|----------|--E-|E--E-|-------------EXX|XXXXXXXX------|-----------|--------------------XX|-XXXXXXXX-|E----------|-----|------------------E|------|XXXXXE---------|E-E-EXXXXX||X
XXX|XXXXXXXX----|-X------|XXX-------|----|XXXXX|X---------XXXXXX|XXXXXXXX------|XXXXXXXXXXX|XX-------XXXXXXXXXXXXX|XXXXXXXXXX|XXXXXXXXXXX|-----|--------------XXXXX|-----B|XXXXXX-oXXXXXX-|----XXXXXX||X
