E----------?---B--B-B---B----B------?-------BB---------------------------B--------?BE------B------E-------------BM?---o------B---E---B-B------------BB---------B---------------------o---?B------B----BB
X-----B-----BB-B--BB--B-----BB-----------------M-----------?-B-----?B--------------BBBB------B---BBB-B-----o---------------------B--B?-?-----------B---------B-o--------B---M--------------B-B---------X
|-B--B-B---B--------B----------B-?---o------------------?------------B---------?-----?-B----------------oB--------B-----------B-----o-------B----------------------Bo--B-B--B-------------B------------X
|--------------------------B?--------------M-B----B------------?--------------------------B--M-BB--?------oB--B------------------B---------oB---B--------BB------B--B--B------o---B-B--------B---------X
|--------------------EB--B-------B--B-B-o----B--------------B?----o--o-o?--B--?--oB--------------o----------------B-B-------------------?-------------------------------B--B------------------o---------
X-E-----B---B-o------B-----------o--B------------B-------B-----------B----B---B-B-BB-------?---------B-------------------------B?----------B-----------o-B----B-----B--?-----B-E--------------B--------X
X-B----------B---B-----------------B----B-B----------BM-B-----------------oE--B-------?--------B--------------B----------------------------B----??-?-----------B----B-----o-o--B-----o------B-B--?------
X----------------E--B------------BM----------B-----------o--B--------E-----B-o-----------------B-B----?----BB-------------B-----------------?----------B----------------B---B---------B--------------?-v
|---------B------B----B----------------B-?-----?---B----------B-B----B------B------------------------B-o---oB-----B-----B--B--B---------B--T-?------?E-B-------B--B----Bo-T-----B-?------?--M-----------
|--B-----------------oBM---------B-B-TB-------?-----B--------?----------E------B---------B-------B--------------------------B------B---o---|---------B-B----o----B--------|B-?-------------------------X
X---B-----?--E---B---B--?------?-----|------B-BBB---?--------B------o---B---E-----B-------------BX---------E-B-B-----B?B-----------B--?---B|-----o??------------oB--------|---B------------------------B
X---------T--B-TB----?--T--?---------|----------B----------------TB---------B--TB--------------T-X----B---TB----T--T--------E----?B-E------|-------o-----------------?E---X-------B---T--------T-------B
T--------?|----|---?----|-T------X---|B------T--T-----o--B-T-T-B-|-------------|---B--------oB-|-X---TB-EX|-----|--|-----B-TB-------BB-----|T-TB------T---------------B---X-BTB-------|B-------|BT-----|
|-T----TT-|----|--------X-|-T----XT--X---T--T|--|E---T-BXB-|B|---X--------TT-T-|--T----X-------|BXT--|B-XXX---TB|-BXB---T--|---B--T-TB-TE--||-|TTB----|-----o-E----TB-----XT-|E----T-B|-----T--|B|------
m-|X---||EX--EEXB---E-o-X-X-|E---X|E-X---|--||--XB--E|-BX-EX-X---XB--E-E--||-|-|--|-o-EX--B-E--X-X|--|X-XXXE-X|-|--X----|-X|---B--|-|-B|X--X|BX||-EB--|-----B-XEBEE|--X---X|oXBEB--|-XX-B---|--|-|EX-BB|
XXXXXXXXXXXXXXXXXXXXXXXXXXXXXXXXXXXXXXXXXXXXXXXXXXXXXXXXXXXXXXXXXXXXXXXXXXXXXXXXXXXXXXXXXXXXXXXXXXXXXXXXXXXXXXXXXXXXXXXXXXXXXXXXXXXXXXXXXXXXXXXXXXXXXXXXXXXXXXXXXXXXXXXXXXXXXXXXXXXXXXXXXXXXXXXXXXXXXXXX
