------------------------------------------------------------------M-------------------------------------------------------------------------------------------------------------------------------------
-----------------------------------------------------------------------------------XXXXX----------------------------------------------------------------------------------------------------------------
----------------------------------------------------------------------------------------------------------o---------------------------------------------------------------------------------------------
--------------------------------------------------------------------------------------------------------------------------------------------------------------------------------------------------------
------------------------------------------------------------------------X-------------------------------------------------------------------------------------------------------------------------------
--------------------------------------------------------------------------------------------------------------------------------------------------------------------------------------------------------
------------------------------------o-------------------------------------------------------------------------------------------------------------------------------------------------------------------
---------------------------------------------------------------------------------------------------------------------------------------------------------------------------------------X---------------v
--------o----------------------------------------------------------------------------------------------------------------------------------------------------------------------------------------------f
-------------------------------------------------------------------------------------------------------------------------------------------------------------------------------------------------------f
--------------------------------------------------------------------------------o-------------------------------------------------------------------???????--------------------------------------------f
------------------------------------------X-----------------T-----------------------------M-X---------------------------------------------------------------------------------------M------------------f
------------------------------------------XX--------------X-|------------------X------------XX---------------------------o-----------------------------------------------------------------------------f
------------------------------------------XXX---------------|-------------------------------XXX--------------------------------------------------------------------------------------------------------f
m----------------------------------X------XXXX--------------|--------------XX--------------EXXXX-----E------E------------------------------------------------------------------------------------------X
XXXXXXXXXXXXXXXXXXXXXXXXXXXXXXXXXXXXXXXXXXXXXXXXXXXXXXXXXXXX|XXXXXXXXXXXXXXXXXXXXXX------XXXXXXXXXXXXX----XXXXXXXXXXXXXXXXXXXXXXXXXXXXXXXXXXXXXXXXXXXXXXXXXXX--XXXXX-----XXXXXXXXXXXXXXXXXXXXXXXXXXXXXXX
