---------------------------------------------------o--------------------------------------------------------------------------------------------------------------------------o-------------------------
----------------------------------------------------------------------X-------------------------------X---------------------------------------------------------X---------------------------------------
------------------------------------------------------------------------------------------------------------X-------------------------------------------------------------------------------------------
----------------------------------------------------?---------------------------------------------------------------------------------M-----M--------------T--------------------------------------------
--------------------------------------------------------------------------X---------------------------------------------T-----------------T----------------|--o-----------------------------------------
-------------------------------------------------------------------------XX-----------------X---------------------------|--X--------------|----------------|--------------------------------------------
------------------------------------------------------------------------XXX----X-----------XX---------------------------|-XX--------------|----------------|--------------------------------------------
----------------------------------MX-----------------?-----------------XXXX---------------XXX---------------XXX---------|XXX-----BB-------|----------------|-------T-----------------------------------v
-----------------------------------------BBBB--------------?----------XXXXXX-------------XXXX---------------------------|XXX--------------|----------------|-------|-----X---o---?---------------------f
---------------------------------------------------------------------XXXXXX-------------XXXXX--------------------------X|XXX--------------|----------------|-------|-----------------------------------f
------------------------------------------------------o-------------XXXXXXX------------XXXXXX-------------------------XX|XXX--------------|----------------|-------|-----------------------------------f
-----------------------------------------------------------------?-XXXXXXXX-----------XXXXXXX------------------------XXX|XXX-------------T|X------------X--|-------|----------------------T------------f
-----------------------------------------------X------------------XXXXXXXXX----------XXXXXXXX?----------------------XXXX|XXX-B------o----||-------------XX-|-------|----------------------|------------f
-----------------------------------------------XX---------X---???XXXXXXXXXX---------XXXXXXXXX-------------------???XXXXX|XXX-------------||---X---------XXX|------o|----------------------|------------f
m--------------------------E----------o------E-XXX------------E-XXXXXXXXXXX--------XXXXXXXXXX----o----------------XXXXXX|XXX-----E----E--||---XX???E?---XXX|-------|----------------------|------------X
XXXXXXXXXXXXXXXXXXXXXXXXXXXX---------------X---XXXXXX----------XXXXXXXXXXXXXXX----XXXXXXXXXXXXXXXX-------XXXXXXXXXXXXXXX|XXX------XXX----||-XXXXX--XXXXXXXX|XXXXX-X|XXXXX----XXXXXXXXXXXXX|XXXXXXXXX-X-X
