---------------------------------------------------o----------------------------------------------------------------------------------------------------------------------------------------------------
---------M------------------------------------------------------------X-------------------------------X---------------------------------------------------------X---------------------------------------
------------BBBBBB-------------------------------------------------------------B----------------------------Xo------------------------------------------------------------------------------------------
----------------------------------------------------?----------------T---------T-----o------------------------------------------------M-----M--------------T--------------------------------------------
---X-----XXX---------------------------------------------------------|----X----|--------X-------------------------------T-----------------T----------------|--o----------------------------------X------
---------------------------------------------------XXXXXXX-----------|---XX----|-------XX---X---------------------------|--X--------------|----------------|----------------------------BBBB------------
-------------------------------------------------X------------------X|??XXXBB--|------XXX-TXX---------------------------|-XX--------------|----------------|--------------------------------------------
-----------------------------------X-----------------?--------------X|-XXXX----|---X-XXXX-|XX--------------XXXX-----X---|XXX-----BB-------|----------------|-------T-----------------------------------v
--------------------------B--------------------------------?o-------X|XXXXXX---|--XXXXXXXX|XX-----------------------XX--|XXX--------------|----------------|-------|-----X---o---?X--------------------f
--------------------------------------------------------------------X|XXXXX----|-XXXXXXXXX|XX-----------------------XXXX|XXX--------------|----------------|-------|-----------------------------------f
------------------------------------------------T-----o-------------X|XXXXX----|TXXXXXXXXX|XX-----------------------XXXX|XXX--------------|----------------|------o|o----------------------------------f
--------------------------??--------------------|----------------?-XX|XXXXX----||XXXXXXXXX|XX-----------------------XXXX|XXX-------------T|X------------X--|-------|---------------------oT------------f
--------B-----------o--------------------------X|-----------------XXX|XXXXX-X-X||XXXXXXXXX|XX-----------------------XXXX|XXX-B------o----||-------------XX-|-------|---------????????-----|------------f
---------B---T---------------------------------X|---------X---???XXXX|XXXXXXXXX||XXXXXXXXX|XX-------------------???XXXXX|XXX-------------||---X---------XXX|------o|----------------------|------------f
m------M-E---|---E---------E----------o------E-X|X--------------XXXXX|XXXXXXXXX||XXXXXXXXX|XX---Eo-------------E--XXXXXX|XXX-----E----E--||---XX???E?---XXX|-------|-------------E--------|-E--E-------X
XXXX-XXXX--XX|XXXXXXXXXXXXXX---------------X---X|XXXX----------XXXXXX|XXXXXXXXX||XXXXXXXXX|XXXXXXX-------XXXX--XXXXXXXXX|XXXX-----XXX----||-XXXXX--XXXXXXXX|XXXXX-X|XXXXX----oXXXXXXX-----|XXXXXXXXX-X-X
