-X?--------------?-----------o---B---?-----?---B----B--------B-B---------B------B---------B---?-----E--B-?---------------B-------?------------B----B-------------o--B-----------B----B--M-----B--------X
Xo------B---------------o---B-----o----B--B-------B---------------o---------------B---B-----------B-B--------------------?-----B--------------?-----------B-----E----M------EB-----------------B-o--E--|
EE-------?----------?-----o-----------------o--------B-------------------------?-BB--------B-------------------B---------------B------------------------B---Bo-BB-----------B----B-?------B-------B-B--X
oT--?----B----------------------B------B-----B-B-----------B-----------------------B---BB----?-o------------------B-----B--------B--------B---------B-E------?-B--------?B---B-----------------B-------T
X?--------------------?--B--M-------------B-----B-?----------B-------B-B---------?-?-----------------o----------------B----------------B------B-------B-B------B-------?---o---BB-BBB--B-------M-------B
|E----?E-----------------------------------?----B------------------------------B-----B-B-B----------B------B-------------------B-------------B-----B--------B---o--B----B?-----------B-----B------B----E
BM-B--BB--?-----B-------o----E-----------------------------M-B-------o-------------B-------EE-----o------E---oB-E----B-E--B------------------------?---B---B------B-----B--------oB---------?----------E
X----------------------------B-------------B-E--------?-B------B----B----B-----------------BB------------B-----BBB-----BB--o------------B-B---BB---B-?-------B------BB------------B--------------?-----v
X-----B----B------E----------------B--------BB---B-M----o-------B?--BB----------?-------BB------------BB---o-----B-EB-B---------B---------------------?----------------------------E----------B?--?M---X
X---T--oB-----B-?-BT---B----------------B----B--------------------------B?-----B----B-------X--------o------B------B--o--------B--------------------B----------?----B--------------B-BB-??-------------E
|E-?|-----B------?-|-------------T--B-----B---------B----------o---------B--?---------------XB-------?---T-------------BB--E-X-----E-------?--------?--?---------B----------B-----------E---B?B--B-----E
XTB-|?---B---XT----|-------E----?|-?--T--------?T--------B---------B------------T-----B-----X----B------E|-----T--B?B------B-X-----B--------------------B----------B-------T-----BB---?-B------B--T----X
B|?-|--------X|T-BT|--B----BB-B--|----|-----B?--|--T--------B--E------------T--T|----------BXB----B----TB|-E?-E|B----B-----B-X---BB--B-EB-------------------------B----T---|T--------o--------BB--|----X
EXT-XT--T--B-X||--||E----T-------X----X----B--o-|-B|-B---------X-o--E-----E-|B-|X-----o---T-XBBB---T---|-|TX--XX----------o--XT--------XT----T-BB--B------T------oB----|---||------TT-----T--BX--B|T----
m-|-X|EX|E-E-XXX--X|X-B-B|E--EB-EXB---X-E--XXBEXX--|-----E-----X----XE----X-|X-|X----oXB-E|EXXXX---|-EEXB||XB-XX--------B-E--X|B---B---X|--B-|-XX-EE---BE-|-E-BE-XEE--EX---X|-E--B-||B---E|---X---||-B-X
XXXXXXXXXXXXXXXXXXXXXXXXXXXXXXXXXXXXXXXXXXXXXXXXXXXXXXXXXXXXXXXXXXXXXXXXXXXXXXXXXXXXXXXXXXXXXXXXXXXXXXXXXXXXXXXXXXXXXXXXXXXXXXXXXXXXXXXXXXXXXXXXXXXXXXXXXXXXXXXXXXXXXXXXXXXXXXXXXXXXXXXXXXXXXXXXXXXXXXXX
