|----M-X-?-------B-----oBo---o---oBM--Bo--o--B-X-o-o-o-B-?-E-B-B-E-o-?-B-B-----B-B-------MB-BX-B-X-oBE-B-----o--Bo-B-B---B-M-B-o-B-|B-BX-------B-B---M-M-----B---E?----B-?-B-X-----?-MBB---o-o-X--?oMo-X
Xo-M-o-?BE-----------?---o-?-E-M--oo---B-MB?---B-B-o-o-M---B---B-B-X---oBB---B-B---BB--M-B---X-o---B-B-o-o-XBBB---BoB--o--BB-B-B---X---XBo----B-B-B--B-B-oMB-----B-----B----EX?--o-o-----o---MBB-?-o-?-B
TB-o-BE--B---o-?-oBX-o-B-BB--B-o---o-------B---M-B-o-o---B---B---o-B?--X-o-?-B-?---o-----o-BBX-?Bo---B--ooBX-o-------B-B-o--EE-o-BB------B---?----B??--o-M-----o-?-o---o---oBoB--BBE-BBo------o--o------
-o-B-MBo-o-M---B---X---------B-Boo-o-oo------o-oB----E---?-------B-M-X---o---BBo-?-?-B---M---X---o-B--BBB--------M-M--B----oBB-T-?---o-M-o-----?-------------X-o-B---?-o-o--?--o-o-B-B---B---B-X---E-BMB
X---?---------E--M-T-ooo-B-B-o-o-?-o---o-B-o-X-B-o-M-B---B-?o----o-B-E-?-E-oB--o-B-E-M---B-XBX-B-oBBBo---B-E---T---B-??EEE---o-|--BE-o-B---o-o-o-------T-----XB-------BoBB-B-o-------o--B--B---o-MBBB---
|--T-o--B--o-oBB-B-|?XB------BBM-ooo---X-----o-?-X-B-ooXBB-----X-o-BBB-B-B-o-o-B--BB-B-o--BM-----M-MM----o-B-o?|---o-B-BBB---o-|-B-B---o--?----B-------|-M---o---B---o---o-M-M-M---B------Bo---B-B-B-?-X
B?B|-o---BB--Mo--o-XB--M----B----E--B-B-MB---X-------B-?-----BBo-B-EB?-B-E--?--?---o-----B-----X-E-B-M?--B-?-o-XBo-B-B-?-----o-X-B---X-?---?-M?o-o-o---X-B-------M-o--B--------o?o-X----B-B----B-o-B---X
BooX----EB-M-B-B-o-B-o?--o-B-B---B-----B-------------B-oB----B-o-?-B-E-B-B-o-------B-E-BBo----B--B--B----B-B---o-X-M-o---o---MB--o------B----B---B-B-BooBE---?-BoB-M-----o-BBo---o--B--B---BB---?--?---v
X----B--B--B?o-X---B-M-o--?B---o-B-----o-------------X-B--B?---o-E---B--B-B?-M-----B-B-o---o-B---?---B--------oM-E---o---o-o--?B-M-----o-B-E--B--X-oBo-BBB---oBM---B---o---oBX----BB-o---E-o-B-oo----EB|
|X-B-B-X---E-----X-----XoT---o-----o-B-o-B-X---MB--X---o-M-o---B-B---?---M?B-o-M-M-B-B-B---?-X-X-----B-?-----o---X-B-----M-B-o-o-E-------?BB-?-o-----M-B-B---B-B---------MBB-------oM----B-B-B-B---BTB-E
XM-?---?oB-B-?---o-o--?B-|---o---o---B-M---o-M-B-?o-BX-BBo-E-o-B-o-M-E---T-B-BB-?o-oBB-----------T----------BM-----o-M-o-o-?-----B-----o---B-o-o-o-?-o-----M-?-B-------?-o-T-M--o--oB?-M-------M---B|M-|
|B-o-oT--o-----E-----?-B-X---B---o-o-o-B-o---B-o-o-?-o-o?B-BT--X-?---BoMB|-??--o---B-----M-o-o-o-|-BT--o--TB---M---?-B-----B-MBo-M---X-o---E-o-X-----B-o---o-o-o-----?-o?B-|B---T--X-----?BB-o-B---EX--X
|----E|B-?---B-B-M?X-------o-------B---o-MB--B--T---TM---oo-|-B?---BBBT--|-----o-?-M-----o---X-M?X-?|-B?B-|T-B-T-B-----B-BMo-EB---Boo?BT---B---o-B---XooTMB----MB----o----BX---B|o-B-----o-?T-?o-o-BX--|
|B-o-BX--BBB-B-B----Bo---E-B-E-?-oT----?-T-B---X|B-o|EToTE--|o-BBoBE-B|-BX-To-B--o-----?B-T----B-M--Xo-BTM||-o-|-TB-T--o-M-X-B-?XB-----|-M-BBoTX---oB--B|B-?-B-----M-o--TM-X----XBTM-T-B---E|-Eo---BX--E
mT-TE?Xo-oBB-M-o-oEoX?-M-B-?-BBE-o|?EM-TB|E?-?-?|T-?|B|-|B--|--B-oBB-?|MBXB|-?---B-BE?Eo--|M-M-B-B--X?Eo|-||-T-XX|-B|?-?---o-B-BX?--E-BX-E-B-X|M-oBME--X|BXo-?-B-oET-TB?|----B-TXM|--|-TE?BBXoB--M-BXo-|
X|X|XTX-X-X-XTX?XMXoXTX-XXXEX?XBXMXEXBX|X|XBXoXoX|X?X?XXXBXoXTXBX?XMXoX?XXX|X?XTXoXXXEX-XTXBXMXXX-XEXBX?XoX|X|X-X|X-XoX?XoX?X?XBXXXTX-X-XBX?XXXBXMXTX?XEXEXoXEXoXTX|X|XTXoX?XMX|X?XEX|X|XTX-XMX?XoXEXTXX
