-X?------------------?-----------------B------------B---------------------------B----B----B---?B----E----------E-------------------B-----B----B----------o----------B-----------B--B----M-----B--------X
XX------B------------B--o---B-----o-------B-------BB---B---------Bo----------?----B--BB?-B---B----B-B----------B---B--------------------------?--------E--B-----E------B---BEB----------------------E--|
E|------------------?-----o-----------------o--?---B---------B--------------------B------M---------------------------------------?---------?-----------BB---B--BB-----------B-------------BB------B-BB-X
o|--?------------B---o-------B-BBB-----M-----------------------E-------------------o----B------------------------BB-----B-----------------B----B----BBE--------------E--?------------------------------T
XX---------------?----?-----MB------------B-----BB?------------B-----------B---------------B-----E---B---------------BB----?---B--------------BE---B--B-B----B-------B----------B-B-BB-----------------B
|B----?------------------------B----------------B----------?---------------------B---------------B-EB--------------------------------B-------B-B------------B---o-------B--B-----M-----B----------B----E
BX----B--B?-----B-------o------------B---------B-----B-------B-------------M----------------E-----oB----------B-E---------B----------B-------------------------B--BB----B------B--B---------?----------E
X|-----------------------------------------o----------?-B-----------B-----------------------B----------B--------B--?----B--B-M-------B--B-B---B----------?-B---B----BT------------B--------------------v
X|----B------?----E-------------------------B-----------o-------B---B--B-------B?-------B-------------B-------------B-Bo--------B----------------o----?------E-------|---------------?--------B---?----X
XX--T---B-----B-?-B----------------B----B-------------------------------B--------B-?BB------X---------------B----B----o----?-B-----------------M----Bo-------B-----BB|-----B-B--------B-?B-------------E
|X-B|-----B--------B----------------BB----B------B--B--B---------B---B-E----?--------?------X--------M------------------BT-------o-----------?-B-?--?----------------|---?--B--------o--E---B-B--B-----E
X-B-|---------T--B-------?-----??o----T---------TX-------B-----?-M---B-B---B----T-----B----TX--B-o------E--B------B-B----|-T-----------------B-----?----B------T-----|---T-----B--B---?-B--B------T----X
BX?-|---------|--BT---B--B--B-B-------|----BB---|X---------EB--------------TTo--|------B---|X----BB-----B---?-E-B------?-|-|------B----BB------------B-----T-T-|-oB--|-B-|--TB-------B--------B---|--T-X
EXT-XT--T-----|--X|-EE----------------X----B--o-|XB--B-----B-T------E--T--E||---X----Bo---T|X-B------T---TT---X----------XoX--T--------TTT---B-BB---------T|-|-|--B--X-B-|--|T------T--E--TT--X---|B-|--
mX|oX|EE|----EX--XX-XXBEBXEE--B-E-B---X-E--BXEEEXX---X-------|------X--|--XX|E--X----BX---||X-X------|E-B||-B-X--B---o-BBXEX-B|--------|||------X-E-----E-|XE|B|--E--XE--X-E||E-----|B-X--||-EX---|B-|-X
XEXXXXXXXXXXXXXXXXXXXXXXXXXXXXXXXXXXXXXXXXXXXXXXXXXXXXXXXXXXXXXXXXXXXXXXXXXXXXXXXXXXXXXXXXXXXXXXXXXXXXXXXXXXXXXXXXXXXXXXXXXXXXXXXXXXXXXXXXXXXXXXXXXXXXXXXXXXXXXXXXXXXXXXXXXXXXXXXXXXXXXXXXXXXXXXXXXXXXXX
