X--------------------------------------------B--?B--oo---B---------------B--B--B----------------------B--o------?--------B?---B----------------------------B-----------B----B--EB---------B---B---B----|
X---------B---------?----------B-----B--B--------------------B------------------o----B-B-----------------B--B-----------------------B-------B---------------B----------------B-B--B----------B---------T
-------B-E-B--B------M---------B-B----------?--------------------B-------------------------------------B----M--------o-------B----------------------------B----B-----------------------BBB-------------|
|-E---B--BoB-----------------B---M------------?B-BB------B-----B--?-B----E------B------o--B-------------?----------B------o-------B-B-B-o---o------------B----B--B-M--E---------------------B?-B-------o
T-B?o---?----B------B--B------o---------------------------------------B--B---B----------B-----------------B----------------?--B---B---B----------B--B-----------------B---B-----?--B-o--B-------------B|
X-----------M--B----------------?-------B-----o--BBB--B-------?-----------B-B---------------B-----------------B----B?B---B----B-----------------------B--------B--?-------o?---B----------B-B------B-?-X
E---------B--------------------------BB---B----?-o------B------------B-----?---MB---B------------------------B---------------B----------B--------------B---M-B--B---------B--B-----------?--B-B--------|
|-----B?------B-------B----------B-B-----------B-----------B---------------------B--------M----------------------------o--E-------B---E---------------?-----BE----BB----B--B---------------E-----------v
X----BB-----B-B--------B-------B?------------B-------------Bo------------------------BB-------------------------------B---B------B---BB--B----?-------------BB-----------------B--B---BB-o-B----B-BBBB--
X--o---o-------------B---B---E---B------?------------------------B--B---B-----------E-B--?---------------------B---------------------------B--------T---E-oB-------M---------------------------B------B-
XT---------B-?----BB-------B-B-T----o-----?-B--------B--B------?B-?-----------E----BB---------TB---------B--B----XB-----B-------B------------o--B-T-|---B----------------B------------B--?B----B-------|
E|-----B-B-T--------------B----|------T--BT-----oB----?---B-------E----------?B------B-B---T--|?--T--------------X----------E-----?--B---------B--|-|-----------------B--------------------------?-----X
E|------?-B|------------B------|------|---|?---BT--B--------------B----B----------B--------|T-|---|-B-B--B-----BoX-T------T-B----B--------B-------X-|-----BTB------T--T--B--X--------------------------|
X|T---B-T-T|B-T--T----B-T--BT--X-T---T|T-B|-----|-XT----B-T-----BB-BT---B--T--T---T--------||-|-B-|TX------------XE|---T--|-------T-T-------B-----XT|E---T-|-------|--|B----XT-------T--B-TE----TT-B-T-|
m||----E|E||XE|--|EB----|-BX|--XB|--E|||-X|-X---|-X|--B---|--E--X---|---B--|E-|---|-B--oE--X|-X-X-X|X-EB--------BXBX-XE|-B|--EB--E|E|--BEB-E----EEX|XX-B-|-X--B--E-|--X-----X|E-E----|-BXE|X--E-||---|-X
XXXXXXXXXXXXXXXXXXXXXXXXXXXXXXXXXXXXXXXXXXXXXXXXXXXXXXXXXXXXXXXXXXXXXXXXXXXXXXXXXXXXXXXXXXXXXXXXXXXXXXXXXXXXXXXXXXXXXXXXXXXXXXXXXXXXXXXXXXXXXXXXXXXXXXXXXXXXXXXXXXXXXXXXXXXXXXXXXXXXXXXXXXXXXXXXXXXXXXXX
