X----o---M------o----B--?--B-----B--?-B------B-------M----B-------B-------------B------B------------B-B--------?---------------------------B--BB--B?--------------BB----------------------------?------X
|B---B-B-----------------------------------B----------B------------BE?---------?-------B-----------------E----------------oB---------------------B------B----------?-------------o----B-B----E-B--o----T
T----------BB-----------B--------B----------B----------------------BB-B---------------o------M--B--------B----BB-----B-------B--------B?-B----------B-M---B?-----------------B----B---B--Bo--B-----BB-B?
|---------------EB-----o-------B---B--B-M-------B---------------B--------o---B--B-----------B-----E--B------??----?----B--------------------------------B---?o---B--oB------------?-----?----------B---X
B----??----o-B--B-----o---B-B---B---?--------BB-------------E---B--------B---?--o--------------?--B--------------------------?B-?---B---B----------------B-B---B---------------B--B-B-----B----------?B|
-----------------------?----B--B----------------B-B--------BB--------?---B-----------B----------B--?--??Bo--------------------E-----B-----E-M-------?E---------B--------?------------B-?B--B--B----B----
X-------oB---M---------------------------------------------B-B----------B----------------B--?----BB-B------M?---------M-----?-B-----------B----------B-----B--------o----B-----o----?--B--B------------E
-----------------B-B----BBB--B-----------B------------B-B------B------------B--B----B----?----B---------------------o--------EB?--------B-----------o----------------B-BB--------B--------------B-E----v
X----M----------M--B---B---B-B---------B---B--B------?-B-----?------------?----------o-------------B------B-----o----E-------B-------B-----------B--?----BEB--B--------B---B--------------------BBB-----
T--------------B-----B--B--B--------B--B-----------------------------------------?--------B--------------B-----------B-----------B-----------o?---B-B-----B---------------B-----o----------B-----B-----X
-B---------------B---M----------------------B-----?-----B-B------------B--------B-B-?------------B-?-?-----------------------------B----B-B-------------B--o-B--B-?---------------------T--B---------B-X
TT----B--T----------------------B---oB----------BB-----?---------------T--B---T------B--?------?--E----T----------ME--?----B--B-B-------------BT--EB-B------------------o-M-------------|B--------BBT--?
X|-BB-T--|---------B----------B-o-----TB--B?--E--------B----T----------|T-B--T|----------------B--B----|----B------B--BTX-----T----T-?-T-------|--X-------X-----------B-------------T---|X------?---|--B
T|----|--|----------T--TE-T---E----B-B|T----T-XT----X-T---TT|--T---TBTB||TB-T||T-----T------E------BT-BXBT-o-----B----E|X----T|TBT-|---|-------|-TX--T----XX----T---B---E-T-T-----o-|---|XT-T--TT---|--|
m|--B-XB-|B---------|B-|X-|--BXEE--X-E||--X-|-X|B-EEXB|-E-||X--|B--|-|-|X|-B||X|----E|---B-BX------X|E-XX|E-EE--E-EB--B|X--EE|||-|-X--E|-BB--B-X-|XB-|--X-XX-X--|B-E----B-|-|-------|---XX|E|E-||E-E|-ET
XXXXXXXXXXXXXXXXXXXXXXXXXXXXXXXXXXXXXXXXXXXXXXXXXXXXXXXXXXXXXXXXXXXXXXXXXXXXXXXXXXXXXXXXXXXXXXXXXXXXXXXXXXXXXXXXXXXXXXXXXXXXXXXXXXXXXXXXXXXXXXXXXXXXXXXXXXXXXXXXXXXXXXXXXXXXXXXXXXXXXXXXXXXXXXXXXXXXXXXX
