------------------------------------------------------------------------------------------------------------------------------------------------------------------------------o----------X--------------
--XX----------------------------------------------------------------------------------------------------------------------------------------------------------------------------------------------------
------------BBBBBB-------------------X--------------------------------------------------------------------------------------------------------------------------------------o---------------------------
-----------------------------------------------------------------------------------------------------------------------------------------------------------------T-----?--------------------------------
---T------X-----------------------------------------------X---------------------------------------------------------------------------------------------------o--|----------------------------------T---
---|-----------------------------------------------------XX------------------------------------------------------------------------------------------------------|----------------------M------M----|---
---|----------------------------------------------------XXX------------------------------------------------------Xo-------------------------------------------B--|-?------?-------------------------|---
---|---------------------------------------------------XXXX------------------------------------------------------XX-----------------M----------------------------|-T-------------X------------------|--v
---|---------T-----------T----------------------T-----XXXXX------------------------------------------------------XXX-----------------------------X---------------|-|--------------------------------|-Xf
---|-XXX-----|-----------|----------------------|----XXXXXX------------------------------------------------------XXXX----X-----------------------XX--------------|-|--------------------------------|XXf
---|---------|-----------|----------------------|---XXXXXXX------------------------------------------------------XXXXX---------------------------XXX-------------|-|-M-----X------------------------|XXf
---|o-------M|---X---M---|----------------------|--XXXXXXXX---XXXXXXXX-------------------------------------------XXXXXX--------------------------XXXX----M-------|-|-------XX----------------------X|XXf
---|---------|-----------|----------------------|-XXXXXXXXX------------------------------------------------------XXXXXXX-------------------------XXXXX-----------|-|o------XXX-----------X--------XX|XXf
---|---------|-----------|----------------------|XXXXXXXXXX------------------------------------------------------XXXXXXXX------------------------XXXXXX----------|-|-------XXXX------------------XXX|XXf
m--|------E--|---EX----E-|----------BBE---------|XXXXXXXXXX-----------E--------E---------------------------------XXXXXXXXX-----------------------XXXXXXX---------|-|---E--EXXXXX-EE---------?--EXXXX|XXX
X--|---XXXXX-|---XXXXXX--|XXXXXXXXXXXXXXX------X|XXXXXXXXXXXXXXXXXXXXXXXXXXXXXXXXXXXXXXXXXXXXX-------XXXXXXXXXXXXXXXXXXXXXXXXXXXXX------XBXXXXXX-XXXXXXXX--------|-|-------XXXXXX-o-----XXXXXXXXXXXX|XXX
