-------------------------------------------------------------------------------------------------------------------------------------------------------------------------------------X------------------
--------------------------------------------------------------------------------------------------------------------------------------------------------------------------------------------------------
-------------------------------------------------------------------------------------------------------------o---------------------------------------------------------------------------------------?--
--------------------------------------------------------------------------------------------------------------------------------------M--------------------------------B-----B--?-----------------------
----------------------------------------------------------------------------B------------------------------T--------------------------------------------------------------------------------------------
-----------------------------------------------------------------------------------------------------------|----------------------------------------------------------------------------BBBB------------
-o---------------------------------------------------------------------------------------------------------|--------------------------------------------------------------------------------------------
-----------------------------------------------------------------------------------------------------------|--------T-------------------???????------------------------------o-X-----------------------v
-----------------------------------------------------------------------------------------------------------|------T-|-------------------------X-------BB-----------------X--------X--------------------f
-----------------------------------------------------------------------------------------------------------|------|-|----------------------------------------------------------------------------------f
-----------------------------------------------------------------------------------------------------------|------|-|----------------------------------------------------------------------------------f
-----------------------------------------------------------------------------------------------------------|------|-|----------------------X-------------------------------------XXX-------?-----------f
-----------------------------------------------------------------------------------------------------------|------|-|----------------------T--------------------------------------------------T--X-----f
-------------------------------------------------------------------------------------M---------------------|----??|?|?---------------------|----------------------o------------------?-----o--|--XX---Xf
m--EE------------------------------------------------------------------------------------------------------|------|-|------E-EE-----E-E----|--??E?E??-E-E---------E-EE-E--BBB--------------EEE|E-XXXE-XX
XXXXXXXXXXXXXXXXXXXXXXXXXXXXXXXXXXXXXXXXXXXXXXXXXXXXXXXXXXXXXXXXXXXXXXXXXXXXXXXXXXXXXXXXXXXXXXXXX---XXXXXXX|XXXXX-|-|---XXXXXXXXXXXXX------|XX-----XXXXX-----XXXX------------o------XXXXXXXXX-|--XXXX-XX
