X----B---B-B------B----------oB-----------B---B------B--------------B-B-?-E--------B---B---------B--------B----------B-----------?----?---E---B--------?---------B------------------------B?--?-B----B?|
|B-E--B------------------o---B---E---B-------B---B---------E---E----------B---B---------------BE----------B-----?----?---B-----B----------B--------B-B-------E---------BB----?oB---?--?--B---B--B------|
EB-B-------o?--------------------B--------------------B---oB-B-B-o--------B-------------------BB-----B-B----------o---------B--------------------B-B-----?--BB-----BB---------------------B-----E---B--T
X------------B----------?---------B-B------EB---------------------B-----o-----------------B---B-------------BEB-------B------B---------------------------o-B-B--------o-o---------------BE------B------X
E---------------------B----------B-B---B---B---M--B------------B---------B-B------o------??---B------B-------B------------B---?-B--------------------------------B---------E--?----------B----?--------T
|--------B---------M--------------B---E------B----B---B-----B-----------B---------B----BM---------B------?-B----------B-------B----o----------B-------o--B------B?-----B--BB-B-------------------B-----B
B-o-B---------?--------?-BB-----------BB-----------B---------------BM--?--------B----------B--BB------oB--B------------------B-B--E-----o------------?------o--------B------BB-BB-------B---------MB--B|
|------------------B-------------------o--?--B---------------------B----B---E------o--B---B---BB-?---------B?---------------B-----B-B-----B---------M-------------o-----------B---------B?-------------v
|-B------------B---B-------------o---------?----M---B------?E--?---B--------B--------M---------------------------B?---------BBo-----------?-----B--------------B-------B------------?------------M---EBX
X---------o------B-B---B--?---------B------------------B-B--B--B-----B-M-----B---BB----------B-M------B----B------------------------------------B-----------------------B---B---------B--------------B-|
?--B----------------?-T-o-----EX---------?-------E----------------------------------M-?-------B-BB-BE----B-----------------------------?-----B--B----B---B---?--------B------B?-----B--------?--B------|
E--B-?----------------|-B?B---BX--T------------B-B------------------------------------------?----TB?B--------T----?---B------B-----E--B----E--B-------B--------------B-T---MT-----T--T-----------------|
B---?--o?---TBT----BT-X--------X--|-o---T---B----B---T--T-B------T--B-----------B--To----------T-|----B----X-|------BT---EB--------B-----T-B----------ET?--?-----B-----|----|E----|--|B---E-T--B-------|
|----T------|-|XTT--|-X--E-----X--X-BT--|--o------B--|--|-----T-X|--TTT--B--TT----E|---B-------|-|--E--T---X-X----TBT|T-BX---T-T--TTE---T|----B-T---ETX|-B-B--TT-B-----X----XB--BB|--XB---BT|---E-T----|
m--B-|E--E--XXXX||EB|-X--X---X-XE-X--|--X-B----B--EX-XE-XXo---|-X|B-|||-----||---oX|-X--B---B--|-X--X--|-E-XBX----|X|X|BXX---|-|--||X--E||------|-X-X|X|---E--||------oX----XEE--X|-BX---EE||EB-BX|----M
XXXXXXXXXXXXXXXXXXXXXXXXXXXXXXXXXXXXXXXXXXXXXXXXXXXXXXXXXXXXXXXXXXXXXXXXXXXXXXXXXXXXXXXXXXXXXXXXXXXXXXXXXXXXXXXXXXXXXXXXXXXXXXXXXXXXXXXXXXXXXXXXXXXXXXXXXXXXXXXXXXXXXXXXXXXXXXXXXXXXXXXXXXXXXXXXXXXXXXXX
