X------------B-------B-------o-------------B-B--------o----B-------B----------B---?-B------B-B------------B--?--B-----------B-M---------------B--?-------------B--------o----------------B---------o---X
|B---------------B------B----------------------B------BB---------------------B---------B---o-------B--B---B----------E----------B--------B------------------------?-?--B---BB--------B---B----B------B-o
X--------------------------------B-BB---B---------------B------?-------o---------------?---------------------B--o?---BB--B----------?----------------B---------------------B-------------------M-------X
|-BB--B--?--BB?------------------B-B-------B------------------B-B-B---------------Bo-----------------BB--o---B---o-B---B-----?-----B------?--?----B------o------B-----BB-BB-------------------B-------B|
X---E-M-o-B-B--B------------B------B-----------------M----------?-----------B------B-----?--------------o------M---------------------B-?-------------B--E-------------------E--------------------------X
X---B-----B-BB---o----------------?----M-------E--------B------BB-----B------------B-------B-----------------B----B----------B-B-BBB--------------?BM---B--------B----------Bo--o--------------?B------X
X------------MB---------------B-BB----o--------B-------------B--B---B--------B--B----------------------B---------B--------?B--o------------------------------?-?-?----?Bo-B---?----------------B--o-M?-X
TB-o-----------------------------oB-----B-------------B------B----------B--------EBBB-----oEBB-B-----o-----EBB-B-------------------?------------------B-----------------B-?--M-------------------B-----v
|-----B---------o--------BE--E---B-B------B-----?-----------------------B----?---B---B----BB-----B-----o---B-----?-?----------------------------B------B----------------------------B-B--------------B-|
----B---------------------B--B----------------?--B--------------B--B------------?---------?------B------------T---------B---------?---M-M-----B-------------------E---------------B------B-?-----------X
XE-----?B------o------------?--------E-------------------E---?--B----------------------M---BBB----?--BB--B----|------B---------BB----------T------BT-o-?-----B-B?BB------------?--------B-------------?-
|B--B--B----BB----B------T-----------B-------------------BB---o--------------------------------------B--------|B-B------T----B-MB----B-B---|-------|----------------------------T--------------oB-B---B-
X--------T--o-BEB--------|-----BT?-?----BB-T--?-?o-T----------B------B-B----T----T----B-----------------------X---T---T-|B----T-----------o|-----BT|TT-BM---------------B--B----|---B---B---T-----?---TX
XXT-----T|--XT-B--E--XT--X--T---|---T---T-X|-----o-|B-o-T-X---------X-------|--TX|TT--T--TT-------T---T----T--X-T-|---|-|--T-T|T-B-T-XB----|-TT--T|X||-----------T--------TB----|---B--T---T|-T-----T-||
mX|---EB||--X|-X-BXB-X|--X--|---|---|--B|-X|----E-BX--XE|BX---B-----X-E---E-|--|X|||--|--||--X-E-E|---|-Eo-|EBX-|EX---|-|-E|-|X|BXB|-X-----X-||--|XX||BBB--E---E-|--BB-X-X|BB---X----E-|---||-|---EE|-XX
XXXXXXXXXXXXXXXXXXXXXXXXXXXXXXXXXXXXXXXXXXXXXXXXXXXXXXXXXXXXXXXXXXXXXXXXXXXXXXXXXXXXXXXXXXXXXXXXXXXXXXXXXXXXXXXXXXXXXXXXXXXXXXXXXXXXXXXXXXXXXXXXXXXXXXXXXXXXXXXXXXXXXXXXXXXXXXXXXXXXXXXXXXXXXXXXXXXXXXXX
