X---B--B-----B------------B-B----------------------BB-o--B--B-B---------B--M--------B-B--------------B----------o----B-------B---?-------?-----------------M-----BE-B------------------B---B---------?-B
EB--B------B--------?-----B----------------B-------------------B----B-------------M----------------B--------o---?--B------B-B---B-o--B----B-----------B-B---------B-----------------E-E-------E--------E
-------------B--BE--------------------------E-------B------B---B--------B----------?----------------B--------o----------B------B--B----BB-----------B-o-----------B---------B-------B-B----B--B--o------
E------------B?-BB------B---------B------?--BBB----?-----B-----------------------------E-------B----B------------B-E--B--B--B-B-----B-------------?---B---BB------B--M------M-?---------B-------------?X
|o-----B-----B----------------------B-------B---o-o-----B--------o---B?----------------B---------------------B-----BB-o----------B----------------------?--------------B-BB---B----o---------B-------B--
XB-------B--B-----------------o-------B-----B--------B?----------B--?--B------?---o----B-----------BB------B--------------------------------B----------E----B------B---------------------MB--B---------?
---B----------------------B-------B-----B------B-B------B---------------B-----BBM-------------B-B-B-B--B--M-------M-B------------------------B---------B-----?--M-----B--------B----------B------B---?-T
|----B----?------B---B-----o-----E----------------------?-o---------------------E-----------------M?---B---B---------------------B--------B----?------E-------------B-?------M---B-o-------B----E--M---v
BE--B------------B-----E----B----B--B--?-?----------------B-?--BE--B-------B----B----------BB---B------?---E----------B------------Bo--B---------B-B-BB--B-------------M------------B--B--------B-----BE
|B--------------??----BX---?---B----------------------BB------M-B-BB?B--------?------------?B--------B-----B-B-----o-----------B-B------B-----B--o---B-------B----B-------o------B--------B------------X
X--------------------B-X----B--B-B-?--E--------------B-o---M-M----B---E-B------E----------?----------------------o----B-------------B---B-------B-?---------ET----------------?--------?----?----------|
|B-?--B---o-------o----X-----?------M-B---M-----M---------------B--BBBB-------BB-?---------B---o---B--------B-----B---o-----------T---------T-------------T-X|-B----------------B-----B-------B------BBT
|-B-----------T-----BETX-------TT---------------B------BM----B---o---------T-BE------B-TT---TTTB------------BE?o-T-----T----B--?-T|----E----|----T--------|-X|---T---?-------T--T---B--------B---------E
?---T--B-T--TB|--B-TTB|X-------||--E-T-------BTB--------TTT---T-----T-E----|-XX---TBT--||--B|||---B--E-E-T---B-XB|-----|---------|X--T-BT---X--B-|-----X--|-X|--E|-----To----|--|T--T-B---T---E---T-o-T|
mE-E|EEX-|XE|-X-EXB||-|X-E--EX-||--X-|--------|X----BB--|||-X-|B----|BB-BB-|BXX---|-|--|X---X|X---Xo-B-XE|-----XXX-B---|-BB--X-E-XX--|BX|--XXEB--X----BX--X-X|-BX|--X--|-E---XB-X|--|--BB-|-E-XBX-|-EB||
XXXXXXXXXXXXXXXXXXXXXXXXXXXXXXXXXXXXXXXXXXXXXXXXXXXXXXXXXXXXXXXXXXXXXXXXXXXXXXXXXXXXXXXXXXXXXXXXXXXXXXXXXXXXXXXXXXXXXXXXXXXXXXXXXXXXXXXXXXXXXXXXXXXXXXXXXXXXXXXXXXXXXXXXXXXXXXXXXXXXXXXXXXXXXXXXXXXXXXXX
