E?----E---------B-----B-----B-?-----------?----B------------B---------B--B--BB--B--B--?------------------M--B---B--------?-------B---------------------E--------E--------------B---------------B-------T
EB----B--M-----------------------------B-B----o---------------B---------B--------B----B----------------------------B--------------------E--B-BEBB------B--------BE--B--------B--E-----E--B-------M-----X
X---B-------------?------------B-?----------------?----------B-o-B---M-----?-------------B----B-----B------------o-----B---?-B------B---B--B--B--------B---B-B---B----B-o-------B-----B--------?M------X
|X------------------------B----------------?--------B--B----------B?---M----?---------?-----o-B--B------B-------------B---------B-B--B------B----?---B-------B-E----B-B--------B---B----E--------B---B-X
XX-------------B-------B---?B------------------B---------B------------B------?-------?-B-------B--------------------------o--B--------?------------------------B------?------------B----B------------B-X
|X----B-------B-----------------?-----------B-B--B-------------B--B-B?-----B--o--------------------------------------------B----------E--------o---B---M--B-----B---------?-------B-------B---o--------E
BT--B------------B----B-BB-B---------B-?-----------------------B-?-----B---BB--B----------o--M------B-----?----B--o---?-B---------B---B-----------------B-Bo-----B-------------?------B---------BM-----X
X|---------?o------------------E--B------??--------B-----B---B---------------B-M-------?--------o--B-------B----o-------------?-------------------EB----E--------------B-------B---------------------?-v
|X-------E------------B----B--?B--------------------------B------------------o------------B----------B-----B--?---M-----B-B----------------B------B-----B--oB--B---E--?--?-B--B--?B-o---B------B----M--E
X-----BB-BB-----B--MBB-------B--?------B---B---------B-----------B------o?-------B--?--B-B-----B-B---------E--B-----B--?----B--------?B-------?--BB----B-----------B--B---B---B------------------M-Bo--E
|--------B-------------------E-----B---------B----------------B--B--?-------------------B------B-B?--T---B-B-----E----?----------------------B--------------------------B--------B----------o-T--B-----|
XX--------E?---B-----?---B-T-BB-----B----------EB------B-T------------B---------B-T------?-------Bo--|-BB-o---X--B--B---B---------B------?----------?----------B--T--E-B----------------------|----oM?-|
X--B------B---B-TB------T--|--------?B---------B-------X-|-------B---B----MB--B---|---T--------TT--B-|---B----X---E--------B--T----T--T---B---?--------B-------ET-|--B------------?----B------|-----B--X
E--T--E---B-XEB-|-----T-|--X-TB-E---oTB-T-TT---B-------XTXE--T-----T-T--------T---|E--|--BE-E--||--X-|--------X-T-XB----E-----|-T--|--|-B-----T----T--BoT------B|-|-T---T-T--T-----B---------B|-BT-----|
mTX|--X---E-XX--|---B-|EX--X-|B-B-o--|--|-||--B----EE--X|XX--|-X---|-|------E-|-E-XX--|-EEXBXE-XX--XB|--------X-|-XX--B-B---E-|-|--XX-|-X-X-EE|----|--XE|--BB--E|-|E|E--|-|--|----Eoo-E---E---X--|---EBX
X|XXXXXXXXXXXXXXXXXXXXXXXXXXXXXXXXXXXXXXXXXXXXXXXXXXXXXXXXXXXXXXXXXXXXXXXXXXXXXXXXXXXXXXXXXXXXXXXXXXXXXXXXXXXXXXXXXXXXXXXXXXXXXXXXXXXXXXXXXXXXXXXXXXXXXXXXXXXXXXXXXXXXXXXXXXXXXXXXXXXXXXXXXXXXXXXXXXXXXX
