B-B-----?-----------------------B---------------B-BB------B-B---------------------B-o-------------B----BB-------------Bo---------------------M---?-------?-----B--------M----B-B-?--?---B-B-?-------B--o
X--------?----B-?----B--B--B-----------B------B--B--M--B-B-B--------------------------------B-B----------B-------------------------E--o-----------B--------B-----------BB-------------------B--M-------X
X--------------------------------B---------------------------------M---B-------------------B-E---------------------?--B------------B--------------------------?----B------------?B----------B-o--B-B-o-|
X---B--B---B--------?----?-------------B---E-------M----B-B-----EB---------B----B------------B--------M--------------------------BB-------------o--B-------------B---B--------------------B---------?---
X--?--B---BB------------------B------------B---------E---B------B--------?-?---------o--?----------------E?-o--------o----------------------------?----------B-----B------EB-------------------?-------?
XE----B------------?-------?B----------o---o---------B--------------------------------------------------?B-----------B---------------B-----B-----B-------------BB--B-?----B----B----B------------------X
-B-B---B----------------------?-----------------B---------------------BM-oB------BB-----------------BB------?B---B-------B---?M------------?-----B-------B---------B----B----------B-------B--------?-BE
|----B----o------------------------o-BB-------------Bo----------B------B------BB--------?------B-------?------B---------------B--o---BBB----B-----------?B------------o-B--B--------B?------E--?-------v
X---B?-------------T------B---------------M---------------B-??-?-----------------B-------------B------B----?---B------------------------------?E---M-----B-----------BB--B-------?------o---BE---BoB--BE
----?--------------|----B--E------------B-B--B-M---------------------B------------?-----B-------------EB--?--B--E-------------------B----------B-------------o-B----?---------------B---B----B-B------?|
M--------o-B-------|--B--?-B---T------------B-T------------------?--?o------?--------E--------B-TB--B-BB---T----B-------B--E------------?------B--------------------------------------B----------B----BX
|---o------B--M-B--X-----B-----|-B------------|-------B---E----?--------B-o----o----BB--B----B--|----------|---------B-----B--B-----o----B?-------BBT-T-B--E-------T--?--?------B----------E-----------?
X----?-----B-T-T--EX-------B-?-|----B-?-B-BB--X-o-------T-B-B-----------------B---T-----------B-|B---X-----|T-o----B----------o---------BT--B-------|T|----B-B----T|M---M--B-------M-------B-----------B
XT-B---------|-|-TBXT---T------X-T---BB--o----X----T---X|---TB--B---X-TB-T-T--B---|--TBT-------T|----X-----X|T-B-B--B---TT--XB-TTTTBT-B--|B-E-----o-|||-------T---||-B-B--------T-T--------T---T-T---T-E
m|--BE-E----BX-X-|XX|EX-|XB----X-|-E----EEEX--X---E|EB-X|E--|-BE-B--X-|-E|-|-o----X-B|-|E------|X-EE-X-----X||----E----E||BXX-B||||-|-EB-XX-XoBBE---X||-XE----|---||-EE-E--EEEB-|-|--EEEX--|EE-|-|--B|-E
XXXXXXXXXXXXXXXXXXXXXXXXXXXXXXXXXXXXXXXXXXXXXXXXXXXXXXXXXXXXXXXXXXXXXXXXXXXXXXXXXXXXXXXXXXXXXXXXXXXXXXXXXXXXXXXXXXXXXXXXXXXXXXXXXXXXXXXXXXXXXXXXXXXXXXXXXXXXXXXXXXXXXXXXXXXXXXXXXXXXXXXXXXXXXXXXXXXXXXXX
