X---B----o----B------B--------?---------------B-------B---------?-----B--------M--E----B----------?----B----?B-----B-B----BB-E--BB-B-------------------B---------------------B---------?-----------B-B-X
|--B-B--B-----B---B-----B-----------B----B?B---?-----------B-B-------------------oB-------B--------------------------B-------B----------------------B-----------B------------M-----?-----------BB-------
|------------B--?-----EB--------B-----------------B--B--------B--------B----?--------------------B------B---B---B--B---------------B----o-------M-----B-------------------------B----B-------?---------B
B-----B-------B-------B-----?------------B-B-----B------B------BBB-----------------?--------------?-------------B----------BB----------------BB-B---------?---------E---------Bo---B-----------------o-o
|-----B----------B--------o-----B-----?---B--------------M--B-------B-B---------------B--------?-------B------------------------B---B-E----o-----B?---B-------------B----------------?--------o--------|
E-------------B-B----------BB?----------------------B-------B--B-----E--?-o-E-B------------------BB-------?E--E--------?--B-------B---B-----?----------B------------B-------B?--------o-B--E------B----B
|-------EB-----------------------------------------B----------B------B------B---B----B-----B--B------------B--B-------B---------------------B----B---------------B?-?---------B-o--B-B-----BB----------|
-B------B-------B----------------M----------------------------?-?----------------------E---B--B--BB---------EB------?--B----B---B-------------B-B----B----o----?-------B----------B--B--o--o--------B-Ev
MB-B-----B------------------------------B-----------------------B---------------------?B---B-----B--BB------B----B--B---------?--------------BB---M------B--------------------B---?--------B?-------T-B-
----------------?----------B----------------------o--------------B-----?---?----T----?-----B-??------B-------------E----------B----?------------------------B---------------B------------B-o------B-|-?|
X-B-----------BB-------------B-?-------B------B?---?B---------------------------|EB----B-B--X-------B----M-B-B-----B---o--B----E-B-----M----B--------B---------T----------------------?----?--------|--X
|------B---B------B------?-------?--T-----?------o-B--------B--------------T---BXBE------E--X--?-----------B?o-------B--------?B--------B--B-X---T-----------?B|---o-------B------------------o-----X--X
X-------B---?-B---B---TT------B---T-|------B--------------To--------T------|---oX-B--o---BB-X-----o----T--?----T-BM----B-?-----------E--T----X---|------T---?-BX-------T---T--B-?---BB-----o--B-----X--|
E---B---T-------------||B-BTTX----|-|-TXET-----B-X-T------|--T-B--E-|-----T|E--TX-X-T-B--X--X----B--B-T|B-----B|TE-------TB----------B--|--T-X-T-|---T-T|T---TBX--E-BB-|---|--TT--TTTB---T---BT---T-XT-X
mX-BXB-X|----BE--o-EE-X|-B-||XXEEB|-|-|XX|-------X-|--X---XX-|BBE-BBXE-E--|XXB-|X-XE|-E-BXX-XE-----B--||X------||X-B--B-E|X--BE------X--X--|EXE|-|---|-|||---|-X--B-BE-X---|E-||E-|||-E--|---X|---|-X|E|
XXXXXXXXXXXXXXXXXXXXXXXXXXXXXXXXXXXXXXXXXXXXXXXXXXXXXXXXXXXXXXXXXXXXXXXXXXXXXXXXXXXXXXXXXXXXXXXXXXXXXXXXXXXXXXXXXXXXXXXXXXXXXXXXXXXXXXXXXXXXXXXXXXXXXXXXXXXXXXXXXXXXXXXXXXXXXXXXXXXXXXXXXXXXXXXXXXXXXXXX
