--------------------------------------------------------------------------------------------------------------------------------------------------------------------------------------------------------
--------------------------------------------------------------------------------------------------------------------------------------------------------------------------------------------------------
-------------------------------------------------------------------------------------------------------------o------------------------------------------------------------------------------------------
---------------------------------------XXXXX----BBB-----------------------------------------------------------------------------------------------------------------------------------------------------
---T----------------------------------------?--------------------------------------------------------------------------------------o--------------------------------------------------------------------
---|-------------?---------------------------------XXXXXXX-------------------M--------------------------------------------------------------------------------------------------------------------------
---|-------------------------B-------------------------------------o???????-----------------------------------------------------------------------------------------------------------------------------
---|---------------------------------------o-------------------------------B------------------------M--------------------------------------------------------------------------------------------------v
---|----------------------------------------------XXXXXXXXT------------------X-------------------------------------------------------------------------------------------------------------------------f
---|-------------------------X-----------------?------B---|-----------------XX-------------XXXXXX------------------------------------------------------------------------------------------------------f
---|------------------------XX--T------------XXXTXXX------|----------------XXX---------------X---------------------------------------------------------------------------------------------------------f
---|-----------------------XXX--|------X--------|---------|---------------XXXX--------------XX-------------------------------T---X-------T-X-----------------------------------------------------------f
---|----------------------XXXX--|------XX-------|---------|X------------XXXXXXM------------XXX-------------------------------|-----------|-------------------------------------------------------------f
---|---------------------XXXXX--|------XXX------|---------|XX----------XXXXXXX-------M----XXXX-------------------------------|----------X|-------------------------------------------------------------f
m--|------E-------------XXXXXX--|---BBEXXXXE----|---------|XXXX-E-E-E-XXXXXXXX-----------XXXXX--------------------E----------|E----------|-------------------------------------------------------------X
XXX|XXXXXXXX------XXX--XXXXXXXXX|-----XXXXXXXXXX|XXX------|XXXXX-----XXXXXXXXXXXXXXXXX--XXXXXX-------XXXXXXXXXX--XXXXXXXXXXXX|XXXXXXXXXXX|XXXXXXXXXXXXXXXXXXXXXXXXX-----XXX-------XXXXXXXXXXXXXXXXXXXXXX
