?-o--------o------o----B----oo-----o--B-----B--------o--------------o----B-B-o----------o-----------------------o--o--------o--o-----B------o-----o--------------B----o--oB----------oB----BB-----o----E
??---o--------o---o----B-B-----B----------B-------------------------------------BB--B---------B-----B-----o--------B---------------B----B--------o-------B----------------------B---------------------oX
--------o--o-----Bo----B---o------------B-o--B---------------B--ooB----------B-o--o--o----o-------o-------------B---oo-----o----------------o--B---------o------Bo---o--------o------Bo----------------?
|--Boo-o---------------B-------o---------------o------------o----------B----------B------------o----B--------B--B---B-------B------o--B--B--B--o-B-----o-B-----B--------------------B-B---------o-B----X
|--B----------B--------B---o-B-----Bo-B---------o---------------------------o--------o---------------o---------o---------B-----------Bo----------B--------B-BoB---BB--B---------oB-------oB-o-----------
T-------o---------------------B-----B----o------M----------------o---B-----B-----------------------------o------B---------B-----B-------------------------------------B------B---------o--o------------E
M----------------------Bo-------o--------------------o-o---BB---B-------------------------------------------o--B---o--B-----B--------o---oB-----------B----B-o------o----B-----o------B---------o------X
B------------o-----BB-----------------------B--------------------------o----------o--o-----B---B-B------M-------------B-o-B---B---B---B-----------M---B----M--B------------?-----T-----o-----BoB-o-----v
?----------------B-------B--o--------T-----M-------------------------------------?-o-o-------------------------------oB-B---------B--------------------------------o-T-----------|---------B--------B-o-
----o---?B-B---M----------------MB--o|--------o?------------B----------B-----------B----------o-----o--o----------------------------o---------BoB-o----------?-M--o--|o-o-------B|------o-----------B--T
------------oB-----------T-----------|---------o------B-B---B-B--TB--------o-M-o--------------B-----------M----o-------------B-o--o---o---o---B-----o---------B------|o--B----oB-|--o----o-------------o
?--o---M---oMo--M---T----|MB-----BB-B|--B--B-T---B-----Bo--?--B-?|--BoB-------B--B--------o-o--B------TM-MB?-o---B----------BB--B----?---BB--B----MT?-o-----?--?M----|B-----?----|-o--o--o------B---Bo-E
|------B-----o--BB-B|----|o-----B----|-----M-|--T--o-o---------B-|-B--T?---?B--o--?--o-M----o--?------|--o--o--oTB-o-B--------?-----oo----TB----BBo|-----?B-----Bo--M|---M----??B|------T---T-o-?------X
X--B-ooo?----B-Mo-o-|----|?-?-oB-?o--|?o----B|-?|Bo-------XTo---M|---B|--o------------?B---------M-B-T|TTMTo-B--|B--o----MT---B--B--B--T-T|--T----B|-oT--B-T--To----B|---B?------|----T-|---|----------o
mo-B-E-E-Bo---B--o--|----|-E-X-Eo---E|--B-B--|--|----B--E-X|B--B-|-X-B|-B---X---E--X----oX-X--X------|X||-|Xo---X------E--|-E---B------|-||--|---oE|E-|-oE-|-X|XX-X--XB---o--X--X|E---|-|---|---XEE--BXT
XXXXXXXXXXXXXXXXXXXXXXXXXXXXXXXXXXXXXXXXXXXXXXXXXXXXXXXXXXXXXXXXXXXXXXXXXXXXXXXXXXXXXXXXXXXXXXXXXXXXXXXXXXXXXXXXXXXXXXXXXXXXXXXXXXXXXXXXXXXXXXXXXXXXXXXXXXXXXXXXXXXXXXXXXXXXXXXXXXXXXXXXXXXXXXXXXXXXXXXX
