|-------------B-M----?---B-o----------B----B-------------?---------B-B-B-oB-------?---B-B-BB--B?----------------------------------------B--B---B-----B---------B-----------B---B-----------B--B--------|
|--B---B--------o-------o--------B-o---EE----------------------------------?-B------B-------B------------------M?-----BB--?---------------B-----B---------------E-----------------------------B-B------E
|--B-B---------------------B---------E-BB-E---B-------??--o-B-?------------------------?BMB-B--------E----B-------B--------BB------B--B-----BB-------------B----B--------------B------BB--B-BB-------B-B
--------------oB--------B------------B--o-B--------BE-------------------------B-M-?------B----BB-----B----?------------BB------------------B-oB------?-----B--------------B-----------B-?-------?------B
|---------------B---------------o-----------BB-B----B-B-----E----------MBB---E-----------oB---o-?-B------------------------?------------B------B-----------E----------o-B--------?B---BB--B---------B-B-
X----?----oB------B-----B---B------B----------B-------------B-----B----------B--------?------B-------?-B-?---B------B--------B---?-----?B------------------B---------E----B------------------B---------B
B----B--------B--------B-o----------?B---------------------B--B----------------------------B--------------------B---o----B---B---------B----Bo-----------------------B----------------o-----B---------BX
X-------------------------B--B---------------------B---B------BB--------?-----B-------------?----------------?---------------B-----------B----------B--------------?----E--B--------B--B----B-?--------v
------------B------------------B---------?--?---B-------------B----------------------M-----B-M---?---BB-?---------M?---B---------------B--E-----B--B------B------B------B-----------------------E------E
B-------?-?----E----------BBB---------?-------B-M----------------------B--B----------o-----B--------E------??--B-BB--------------B--------B-----B----------o-------------B-------------M---B----B--B---X
X-BB-----B-----BM--??M-----------------B-------B-------------------T--------------B----------------BB--------BB-------E--------E---------------T-----------M---------B--------B-----B------------------E
-B-------?------------B--T?B---T---------E----E--E-----?-----------|-B-----------------?-B-B-------B----------?--T----B--------B---------------|-B------?------------B------------T---E-T--E------------
|----T--------------T----|----T|T-?------BB---B--XB-----B----------|-----------T--------T-?----o--T-----B------T-|-----B---------B-------------|B-?----B--------B----?------?-----|--BB-|T-B--B--------X
X-B--|-T----T--X-T--|----|---T|||-B------T--B-T--X--T----T-T-------XT-B----TT--|XT------|B-B----B-|-TT-XTT----B|-X-T----B----E----TT----B------|--B----o--T--------ET---------E---|-B-T-X|--T--B--T---TX
m-XEE|E|-E--|-EXE|-X|-X-E|---|X|X--E-E-E-|----|-XXX-|---E|-|-----X-X|-----B||BXXX|--Eo--|--B--E-X-XE||EX||----B|EX-|EBX--E--EX-B--||-----------X---------E|-EBE-BX-X|EE---B---B-B-X---|EX|--|-----|B--|X
XXXXXXXXXXXXXXXXXXXXXXXXXXXXXXXXXXXXXXXXXXXXXXXXXXXXXXXXXXXXXXXXXXXXXXXXXXXXXXXXXXXXXXXXXXXXXXXXXXXXXXXXXXXXXXXXXXXXXXXXXXXXXXXXXXXXXXXXXXXXXXXXXXXXXXXXXXXXXXXXXXXXXXXXXXXXXXXXXXXXXXXXXXXXXXXXXXXXXXXX
