o--B-----------------------B-B------B--B-o----o-------------------------------B--o--B---o--B---------o---Bo----------------------------o---------------------------------------------------------------B
|B----o------Bo-----B--------B-----------BB-----------B------o--------------------o-----o--------------B----o----B---B---o-o-----------B---B-------------------o------o-----------oB------o-------o-----
-----------------------------o-o----o--------------------B----o-------------oo-B-o-----o---------------------B---o-------Bo------B-----------------B-----------oB-----------o----------B-------------B-o
X----o--o---B--------B------B----------------------------o----------------------o-------B---------------------B--B--------------o--B--o--------------------o--------B-----------------B-B--o---o-------B
X---------o----B-o---o----B-o------o-----o-o----B---------------BB-------o--------------o-----------------B---o----------------B----------B-----------o-------------B-----------------o-------B-B-----?M
E--o---------------------o------o-M-------------------o-B------o------B-------B------------B----o-------------------------o---------B------B---B----M-B------BB-------o----------------oBBo----B-B-----T
T------------------B----------------o----------------------------------B----B--------------------B--o----B------B--o--B-B--------o-------------B-----o----B---------o--------o----B----------ooB-------X
M---------------B------------B--------B----------B----------------------o--------------------------------------Moo-B------B--------------B-------B---------o----MB-------oB--B-----o--B-----------?-B--v
--B-T--------B--------B----o-----------B---------B-------------------o-------o---------B-----o-------o-----o-------------------B------B-BM------oo-------B---o--------o-o-------B--------oo-------B----X
E---|---------------------o------o-Mo---------------------M----B----o-------------o-o-------------o-----------o-o--------------------B----------B-o-?---------------------?----------B----B---?--------|
oo--|----o-o--B---------BB---B------o----o-o-------------B----B-----------B-----oo-----B-B--oB-B---B---oo---------------T---------------------------------T--------o------------T---B---------------B--T
E---|-----------Bo------o--?-BB------?----------o------Bo--M-o------------o-B-?--o------o-------BT-----M--?--B-?--------|?-o-o-----------o-B------M---oB--|-o--?----o-------MB--|--------oB----B---M-B-X
|---|-B-M-----o-o---?--?--o-----T-o-o--------------T------o-B--------T-----?-o----------------?--|-----------------?T---|-----------oB---M---o-------M---?|----------M-------??-|B-T---B----?-B-------BE
M?--|--o-?MT----------?-----??--|---?---T------o---|--?---?-B----B---|B---o----------T--B-----o--|------o-M---o-----|---|B---?-----oB--B--T----o?--T--o---|-----?---------MB----|--|----------T---o-?--X
m-X-|----B-|------B-------X-B-o-|--B----|----o-E-B-|B-BB-B----E--X---X-oB---E------B-|--oXo-E-X--|Bo-o-B-EB----X----|E--X----B-------E---X|------X-|------|B------B--------E--E-|--|--B----E-B|-X------B
XXXXXXXXXXXXXXXXXXXXXXXXXXXXXXXXXXXXXXXXXXXXXXXXXXXXXXXXXXXXXXXXXXXXXXXXXXXXXXXXXXXXXXXXXXXXXXXXXXXXXXXXXXXXXXXXXXXXXXXXXXXXXXXXXXXXXXXXXXXXXXXXXXXXXXXXXXXXXXXXXXXXXXXXXXXXXXXXXXXXXXXXXXXXXXXXXXXXXXXX
