|-------------?-o-------B-B---B-----?-----------------E----M------B------------E-------B-?----o-----o-----------------------------------------------B--o--------------------B--B--------BBB-o----------X
|-B--B---------B-------------------B-----B---B----B---B------?-------BE---B--B-B-E----------?----------B----B--------------------?--B--B?--B--------B-oB----B---------B---o-------------------M--------T
X----B--B------------------------B----------B-B-----------------B-----B----------B-------B---------M-M-----B-------B----------BE--B----?------B----------------E-----------B--oB---B---B----------M-B--X
E---------------------?------------------o-----?M-----B---BB-B--------B-------B-------o--B-------------------?---B-------BB----B--B----B--?-------B---------B--B-----------------------------------B--BX
|--o?------------------BB---B---------?B---B-------M-?--------------B-------------B----------------------?----------------?-B----B---------------------------B-------------------B-B-------------------X
|-----------------------------------B---B----B--------B-B----E------------B------------o---?----------?----?----------B-B---------BB----------B---B----------------B--------B--B-----------------B---o-|
X?----?-B----B-------------------B----E--B----B---M----B-----B------------o----?------?-B----------------B------------------------o--?----------------------------------B------------------------------X
X---------------B------?--?-----------BB----------B--------------B------B---B------B----B-B------------------B-------------?-?----------?------B-------B---------------o?---B---B------?--?-------B--B-v
B------Bo--B---?----B---B----B-----o--------B--o------o---BB------B--------B----------------E---------B--E----B-----?B-----------------------E----B-B-BB---o-----?B----------------------BE------------X
X-------B----------------E--------BB-?------------------------?B----------B?BM------ET------B---TB------BB--B----B----TB-------------B--B----B------E-E---?-----o----B-----B---B----------B----------B?X
|-------B---T--B-------?-B--B--T---B-----------o-----B---------------------B--------B|---------B|---?-------B---------|-----------o---------------E-X-B---------o----------------------------M----B----X
------B-----|-B----------------|?---------o-----B------?-------?---------------BB----X---oT----B|-------T-----?----B--|B-?-----TB---------------B-B-X-----T----------?--------BBM------------B-------B-T
|TE-BB----B-|--TB------T----TB-|------------T--?--B-T-------T-T-B--------?--X-----?TTX-?--|T---B|M--T---|B?-T----B----X--------|---------B----------X--BB-|-T?---BB----T-T---BE------T----X---------T---
X|B---TTB-E-|--|B-B--B-|-B--|XB|T----BB-----|T------|T-E----|-|----------T--XT----T||X---T||----|BXB|T--|T--|----T----XT-T--TBT|--T-T---T-----BT----X--T--|-|----oB-B--|-|ET-BX-TB---|--T-X---o-B--B|B-|
m|B---||--X-|E-X-X--B--|-X--|XEX|--B------EEX|----EX||-B----X-|EX--------|--X|--B-||XXE-E|X|B---X-X-X|EE||EB|EB--|---EX|-|-o|-|X--|-|--X|--BX-E|--B-X--|--X-|-Xo-BE----X-|X|--X-|-E--|-B|-X---BB--E-X--B
XXXXXXXXXXXXXXXXXXXXXXXXXXXXXXXXXXXXXXXXXXXXXXXXXXXXXXXXXXXXXXXXXXXXXXXXXXXXXXXXXXXXXXXXXXXXXXXXXXXXXXXXXXXXXXXXXXXXXXXXXXXXXXXXXXXXXXXXXXXXXXXXXXXXXXXXXXXXXXXXXXXXXXXXXXXXXXXXXXXXXXXXXXXXXXXXXXXXXXXX
