E------o----------------------B---o--o--B------------------------o------o------o-------B-------------------------------o---------BB------------B------------o---------------------Bo--------o----o-----B
----------------o-------------------------------------B----------------B-------------------BB--------o---o--o----o---o-----------------o-------------------------------o----------------------o--------X
E-----B-----o--o--------------o----BB---o-----B----o--o-Bo-------------B---o-------------Bo-------o--o-------B--------B-----------------o------------B---------oB-B---B-------------o------------------M
X--------o--BB-------------o----------------o----------B----------o---------------------------o--o-----B-B-------Bo------o----BB------oo--B-------------------------------------------B----o------B-o--B
?-------------o-----o---------B-----------------B---------------oB--Bo---------------------------------Bo--B--o-------BB--------o------B------------------------B---B----------------------------------T
E-----Bo--B--------------------o--oB------B-----o--------------o----Bo------o-------------------------B------B----o-----o-B-------------------B-----o--------B------------------o----------------B-----X
M-o-----o----B------------Bo---B-B----------------------------------------Bo-o------B---?----o-----ooB-----------B---------B---B--------B--------o----------B----------------------------M-------------?
E--------B-------o-o-----B------------oo----------o---B--------oo------------o-----?--B--B-B------B--B-------------o---B-B-------------o----------B---o---------B----------B---o--------------------B--v
o--o------------------------B-----------B----------------Mo------o--o-----BBB-B------BB------o-B-----oB-o-o-------o-----M------Bo---o--o?--------o----------------------------B-----o-M--Bo-B------o--B|
|--oo-Bo---------oB-------o----B-----------B----------Boo---?--------B---------B-----o----------B-----------o----o-------------o---------B-------B----------o--B---------B--------B-------B----o-oB--B-X
E-------------B---------BB--------TB---o-oB--------B--------B-B----------B--BB--o-------B?------BB-----oo----B---------------B---BB-B----B--------o-------------------------------------?--------------|
B-----------?-------------M-------|-B----T---?--------Mo-B----MM------o---o------B?-------T----------?-o----?----------------?------T--------------o--T------B--BMB--?--o---------B---B----M---------?-X
------B----------?----BM----------|----B-|-----M--BB--o--BM------T---T-o-o--------Bo-?----|------M-?-----o--o--------B---M--B-----M-|--M---------Bo-?-|----M----B--o---o-------M---B-o?M----------B----M
?---------o-------------------M---|-B--?T|---------------T---M---|---|----o-------?TM----M|--------BM--?----o-B-----T---T-T---M--o--|--B-----B-B------|--Bo----------?o---M-T------T------TBT--B-?-?T-?B
m-o-o-B--B---BXo--Xo--E----B------|-----||----------B--E-|-------|---|-o---X---XBX-|------X--X--o-B----BoX--o-------|---|-|----E-X--|X--------EB-----E|----B----BE--o--o----|----B-|---XE-|-|------B|--T
XXXXXXXXXXXXXXXXXXXXXXXXXXXXXXXXXXXXXXXXXXXXXXXXXXXXXXXXXXXXXXXXXXXXXXXXXXXXXXXXXXXXXXXXXXXXXXXXXXXXXXXXXXXXXXXXXXXXXXXXXXXXXXXXXXXXXXXXXXXXXXXXXXXXXXXXXXXXXXXXXXXXXXXXXXXXXXXXXXXXXXXXXXXXXXXXXXXXXXXX
