X---B--------------------MB-B--B-----------------B--BBo--B--B-BB-B------BB-B---B----B-B--B-o--------------------o?---------B---M-B-----B-------------B-----------EE-B------------------------B-------E-B
E--?B---------------?B----B----------------B------------------------BB------------M-------------------------o---?---------B-B---B-o------MB-----------B-B--------BB--------B-----B-BE-E-------E--E---B-E
-------B--------B------------------------B--E-------B--------B-------?--B----------B----------------B-------------------B---------B-----B-----------BEo-----------B---------B-------B-B----B--B--B------
E-------------?EB-------B--------oB------?--B-B--------------------?---------B---------B-B---B------B----B------------B-----BBBB----B-------------?--BB--?B-------BB--------M-?---------B-------------?X
|--o-------?---B---------B----------BB------B---o-o-----B-------------?E---------------------B---o---?---------?----B-o--M------------------------------?------------E----BB--B----B-?-------B----------
XB----------B--------------B--o--B---BB-----B---------??-o---B-----B?--B---o--?--Bo----B------------B------------B-----------B---------B----B------B--------B----B-B-B-E-----------B------B------------?
-B-----B-----B------------B-------B-----B------B--------B--B---------?--B-----B-M-------------B-B-BBB----?M-------M-B--------B---B------------------------------M-----BB-----E-B---B------B------------T
|---------?--------?---------B---------------B---------B?-o------B--------------E----------B------M----------------B----------------------B-----------E-------------Bo?--B---B-------------B---BE----E-v
B---BB---?------------------B-------B--------------?------B-?---E---------------B----B-B----B---B---------------------BB------------o----------E------B-----------------------------BB----------B----BBE
|----------?-B--?--B--B--------------------------?----B-------M-B-B-?--o------?------------BB----------------T--------------------------B-----BB-----------?------B-------oB---------M---oB------?-----X
X--B-B-M--------------------B---------E----B----------------------B---E-B-----------------?----B-o-B---B-----|-----B--B--------o----B---B-------B-?------M--E--B---------B----?-------------?----------|
|-----B---o------Mo--------B--------M-B--TM----BM------B--------B---B-B-------B----------T-------?-----B-B--BX---BB---o-----------T---------T----B--------T-X-------------------B-----B-------B--o----BT
|-B-----------T--E--B-T----B---BT--------|------B-------M--------------o---B--E--B------T|-BT-T-------------BX?E-----T-----?B-----|---------|T---------B--|-X--B-M---------T----T--BB--B-----T---------E
?---T-------T-|--B-TT-|T-----B--|------X-|----TB---o----TBT--oTB----T-E-------XT--T-TB--|X--|-|T--B--T-T-----X-BB----|-T-T-o------X--T-TT---X|---E-----T--|-X--BE--T-T--o--|----|---TTB--TTT-|E--TT-o-T|
m---|-EE-BX-|EXBE-B||-||-B-XEX--|E-B---X-X----|-----B--X|X|BXE|--B--|XB-BX--BEX|--|E|B-EXX--X-X|-EXX-|-|E--E-X--XB---|-|-|B--X----X--|B||---X|B--B---BB|--XEXE-XX--|X|-----|-EBBXE--||--B|||E|XEX||BE-||
XXXXXXXXXXXXXXXXXXXXXXXXXXXXXXXXXXXXXXXXXXXXXXXXXXXXXXXXXXXXXXXXXXXXXXXXXXXXXXXXXXXXXXXXXXXXXXXXXXXXXXXXXXXXXXXXXXXXXXXXXXXXXXXXXXXXXXXXXXXXXXXXXXXXXXXXXXXXXXXXXXXXXXXXXXXXXXXXXXXXXXXXXXXXXXXXXXXXXXXX
