B--------------------E---B---B-----BB-----------B------------o---B----------B-B--B---------------------?--E----------------------------B--?--E-B--B----B----B------o-----?------B-------B--------o--B-o|
|--------B-o---------B---------?------BB-E--------?E--------------------E----------B---BB--------o-----?--B-------B----B---------------------B------M-B-B--B-------------E------B----?B----?-----------E
T-------------------B--------B-----------B---------B--------B---------o-B---------B--------------B--B----B-------?---------------------?----E--------?---------?-------BoB?------M---B-------B---------B
|-------------B--------?--------B--B----B----------------E?--B---B?B-----------o----------------------B--------------B----B------B----------B-----------------?-------?-------?---B--------------?-----X
X----E-?----B----------B----o------B---------B---B-------B--o---------B-----B---B---?-----------------------------------B-------B-------M----?---?-----------------------------------------------------|
|----BB----B----------------B----?------B---------B--B--?---------B------------BBB--B---B---------B-----------------------B---?---o----------------?B------E------------B---B--------------B-----------X
E----B-----------------B--------?---B--------BE------------------------------oB--B-M-----------B--B----B-------------------E-B-B---------------------------B-----B-----o--------B--B-B------------?--B-|
|---B-----------BB-o-----?-M-E---------E----?-B----------B----EB-?------------?----B-------?---B--B------------------B-----B----------B?----?---------------BE----B-B-?------o-------------------B?----v
|----------------o--------M--B--?---B--B----------------------B?-----------------------------?-o------B-B-----B------------B------B---------B---oBBMB-----?B-B?-------B--------B-B--?---------B-B-----oT
T----B------------E----B-B---------B-BBB--B---------------------?--------------------------B-E-B--------B---------------o---B--B-??-----B-------B---------------------B-----------o--B-----------------X
------------------B-E-?-o-----?-----B---B-------B-------------------------o-B--------------T-BB-----B---B--------B--o---M--?B-----o------------------------BB-B------------?-?----E-------?---B-----B--|
X-------------------B-----------------------------B--BB--------------------------B--------?|-B-----B-------------B--X------?----M---------B----M---------------------------B---B-BB-B----X-----------o-|
T--------?--B----T---T-----M----?--B?---------T--BT------T-M-------T---B----BoT-T-----T?--?X--------T---------------X-B-----T------o--TT----E------B--T--TBTB---T-T?-T-B?------BBTB--B--TX?------T--TX-B
E-----B-----T----|---|---BE---B-----B-T-----B-|---|B--T--|o--------|---T---T--|-|----T|----X-E--TT-T|--T------------X---B---|BT-----T-||B-o-XTT-------|E-|X|o---|-|--|-T-B-------|ETo---|X--T---B|TT|X-B
m-B-B-----E-|E--B|-E-|---XXE--XE----B-|--BB-E-|E-BX-EX|-B|X--------|B-B|E-E|--|-|o---||---BXEBBX||X|X--|--o------BEBXE------|-|--E-E|-||----X||--EEBB-|B-|XX---XX-X--|-|-B--E--EE|B|E---XX--|E---||||X-E
XXXXXXXXXXXXXXXXXXXXXXXXXXXXXXXXXXXXXXXXXXXXXXXXXXXXXXXXXXXXXXXXXXXXXXXXXXXXXXXXXXXXXXXXXXXXXXXXXXXXXXXXXXXXXXXXXXXXXXXXXXXXXXXXXXXXXXXXXXXXXXXXXXXXXXXXXXXXXXXXXXXXXXXXXXXXXXXXXXXXXXXXXXXXXXXXXXXXXXXX
